Academy Map (The Awakening)|Map:Academy Map (The Awakening)
Acton's Nightmare (The Awakening)|Map:Acton's Nightmare (The Awakening)
Arachnid Nest Map (The Awakening)|Map:Arachnid Nest Map (The Awakening)
Arcade Map (The Awakening)|Map:Arcade Map (The Awakening)
Arena Map (The Awakening)|Map:Arena Map (The Awakening)
Arid Lake Map (The Awakening)|Map:Arid Lake Map (The Awakening)
Arsenal Map (The Awakening)|Map:Arsenal Map (The Awakening)
Ashen Wood Map (The Awakening)|Map:Ashen Wood Map (The Awakening)
Atoll Map (The Awakening)|Map:Atoll Map (The Awakening)
Bazaar Map (The Awakening)|Map:Bazaar Map (The Awakening)
Bog Map (The Awakening)|Map:Bog Map (The Awakening)
Bone Crypt Map (The Awakening)|Map:Bone Crypt Map (The Awakening)
Caer Blaidd, Wolfpack's Den (The Awakening)|Map:Caer Blaidd, Wolfpack's Den (The Awakening)
Caldera Map (The Awakening)|Map:Caldera Map (The Awakening)
Canyon Map (The Awakening)|Map:Canyon Map (The Awakening)
Castle Ruins Map (The Awakening)|Map:Castle Ruins Map (The Awakening)
Cells Map (The Awakening)|Map:Cells Map (The Awakening)
Cemetery Map (The Awakening)|Map:Cemetery Map (The Awakening)
Channel Map (The Awakening)|Map:Channel Map (The Awakening)
Chateau Map (The Awakening)|Map:Chateau Map (The Awakening)
Colonnade Map (The Awakening)|Map:Colonnade Map (The Awakening)
Colosseum Map (The Awakening)|Map:Colosseum Map (The Awakening)
Core Map (The Awakening)|Map:Core Map (The Awakening)
Courtyard Map (The Awakening)|Map:Courtyard Map (The Awakening)
Coves Map (The Awakening)|Map:Coves Map (The Awakening)
Crystal Ore Map (The Awakening)|Map:Crystal Ore Map (The Awakening)
Cursed Crypt Map (The Awakening)|Map:Cursed Crypt Map (The Awakening)
Dark Forest Map (The Awakening)|Map:Dark Forest Map (The Awakening)
Death and Taxes (The Awakening)|Map:Death and Taxes (The Awakening)
Desert Map (The Awakening)|Map:Desert Map (The Awakening)
Dunes Map (The Awakening)|Map:Dunes Map (The Awakening)
Dungeon Map (The Awakening)|Map:Dungeon Map (The Awakening)
Excavation Map (The Awakening)|Map:Excavation Map (The Awakening)
Flooded Mine Map (The Awakening)|Map:Flooded Mine Map (The Awakening)
Fungal Hollow Map (The Awakening)|Map:Fungal Hollow Map (The Awakening)
Gardens Map (The Awakening)|Map:Gardens Map (The Awakening)
Geode Map (The Awakening)|Map:Geode Map (The Awakening)
Ghetto Map (The Awakening)|Map:Ghetto Map (The Awakening)
Glacier Map (The Awakening)|Map:Glacier Map (The Awakening)
Graveyard Map (The Awakening)|Map:Graveyard Map (The Awakening)
Grotto Map (The Awakening)|Map:Grotto Map (The Awakening)
Hall of Grandmasters (The Awakening)|Map:Hall of Grandmasters (The Awakening)
Jungle Valley Map (The Awakening)|Map:Jungle Valley Map (The Awakening)
Lava Chamber Map (The Awakening)|Map:Lava Chamber Map (The Awakening)
Malformation Map (The Awakening)|Map:Malformation Map (The Awakening)
Maze Map (The Awakening)|Map:Maze Map (The Awakening)
Mud Geyser Map (The Awakening)|Map:Mud Geyser Map (The Awakening)
Museum Map (The Awakening)|Map:Museum Map (The Awakening)
Necropolis Map (The Awakening)|Map:Necropolis Map (The Awakening)
Orchard Map (The Awakening)|Map:Orchard Map (The Awakening)
Overgrown Ruin Map (The Awakening)|Map:Overgrown Ruin Map (The Awakening)
Overgrown Shrine Map (The Awakening)|Map:Overgrown Shrine Map (The Awakening)
Palace Map (The Awakening)|Map:Palace Map (The Awakening)
Peninsula Map (The Awakening)|Map:Peninsula Map (The Awakening)
Phantasmagoria Map (The Awakening)|Map:Phantasmagoria Map (The Awakening)
Pier Map (The Awakening)|Map:Pier Map (The Awakening)
Pit Map (The Awakening)|Map:Pit Map (The Awakening)
Plateau Map (The Awakening)|Map:Plateau Map (The Awakening)
Plaza Map (The Awakening)|Map:Plaza Map (The Awakening)
Precinct Map (The Awakening)|Map:Precinct Map (The Awakening)
Primordial Blocks Map (The Awakening)|Map:Primordial Blocks Map (The Awakening)
Promenade Map (The Awakening)|Map:Promenade Map (The Awakening)
Reef Map (The Awakening)|Map:Reef Map (The Awakening)
Residence Map (The Awakening)|Map:Residence Map (The Awakening)
Shipyard Map (The Awakening)|Map:Shipyard Map (The Awakening)
Shore Map (The Awakening)|Map:Shore Map (The Awakening)
Shrine Map (The Awakening)|Map:Shrine Map (The Awakening)
Spider Forest Map (The Awakening)|Map:Spider Forest Map (The Awakening)
Spider Lair Map (The Awakening)|Map:Spider Lair Map (The Awakening)
Strand Map (The Awakening)|Map:Strand Map (The Awakening)
Temple Map (The Awakening)|Map:Temple Map (The Awakening)
The Coward's Trial (The Awakening)|Map:The Coward's Trial (The Awakening)
Thicket Map (The Awakening)|Map:Thicket Map (The Awakening)
Toxic Sewer Map (The Awakening)|Map:Toxic Sewer Map (The Awakening)
Tropical Island Map (The Awakening)|Map:Tropical Island Map (The Awakening)
Underground River Map (The Awakening)|Map:Underground River Map (The Awakening)
Underground Sea Map (The Awakening)|Map:Underground Sea Map (The Awakening)
Vaal Pyramid Map (The Awakening)|Map:Vaal Pyramid Map (The Awakening)
Vaal Temple Map (The Awakening)|Map:Vaal Temple Map (The Awakening)
Villa Map (The Awakening)|Map:Villa Map (The Awakening)
Volcano Map (The Awakening)|Map:Volcano Map (The Awakening)
Waste Pool Map (The Awakening)|Map:Waste Pool Map (The Awakening)
Wasteland Map (The Awakening)|Map:Wasteland Map (The Awakening)
Waterways Map (The Awakening)|Map:Waterways Map (The Awakening)
Wharf Map (The Awakening)|Map:Wharf Map (The Awakening)
Academy Map (Atlas of Worlds)|Map:Academy Map (Atlas of Worlds)
Acid Caverns Map (Atlas of Worlds)|Map:Acid Caverns Map (Atlas of Worlds)
Ancient City Map (Atlas of Worlds)|Map:Ancient City Map (Atlas of Worlds)
Arachnid Nest Map (Atlas of Worlds)|Map:Arachnid Nest Map (Atlas of Worlds)
Arachnid Tomb Map (Atlas of Worlds)|Map:Arachnid Tomb Map (Atlas of Worlds)
Arcade Map (Atlas of Worlds)|Map:Arcade Map (Atlas of Worlds)
Arena Map (Atlas of Worlds)|Map:Arena Map (Atlas of Worlds)
Arid Lake Map (Atlas of Worlds)|Map:Arid Lake Map (Atlas of Worlds)
Armoury Map (Atlas of Worlds)|Map:Armoury Map (Atlas of Worlds)
Arsenal Map (Atlas of Worlds)|Map:Arsenal Map (Atlas of Worlds)
Ashen Wood Map (Atlas of Worlds)|Map:Ashen Wood Map (Atlas of Worlds)
Atoll Map (Atlas of Worlds)|Map:Atoll Map (Atlas of Worlds)
Barrows Map (Atlas of Worlds)|Map:Barrows Map (Atlas of Worlds)
Bazaar Map (Atlas of Worlds)|Map:Bazaar Map (Atlas of Worlds)
Beach Map (Atlas of Worlds)|Map:Beach Map (Atlas of Worlds)
Bog Map (Atlas of Worlds)|Map:Bog Map (Atlas of Worlds)
Bone Crypt Map (Atlas of Worlds)|Map:Bone Crypt Map (Atlas of Worlds)
Burial Chambers Map (Atlas of Worlds)|Map:Burial Chambers Map (Atlas of Worlds)
Caer Blaidd, Wolfpack's Den (Atlas of Worlds)|Map:Caer Blaidd, Wolfpack's Den (Atlas of Worlds)
Caldera Map (Atlas of Worlds)|Map:Caldera Map (Atlas of Worlds)
Canyon Map (Atlas of Worlds)|Map:Canyon Map (Atlas of Worlds)
Castle Ruins Map (Atlas of Worlds)|Map:Castle Ruins Map (Atlas of Worlds)
Cells Map (Atlas of Worlds)|Map:Cells Map (Atlas of Worlds)
Cemetery Map (Atlas of Worlds)|Map:Cemetery Map (Atlas of Worlds)
Channel Map (Atlas of Worlds)|Map:Channel Map (Atlas of Worlds)
Chateau Map (Atlas of Worlds)|Map:Chateau Map (Atlas of Worlds)
Colonnade Map (Atlas of Worlds)|Map:Colonnade Map (Atlas of Worlds)
Colosseum Map (Atlas of Worlds)|Map:Colosseum Map (Atlas of Worlds)
Core Map (Atlas of Worlds)|Map:Core Map (Atlas of Worlds)
Courtyard Map (Atlas of Worlds)|Map:Courtyard Map (Atlas of Worlds)
Coves Map (Atlas of Worlds)|Map:Coves Map (Atlas of Worlds)
Crystal Ore Map (Atlas of Worlds)|Map:Crystal Ore Map (Atlas of Worlds)
Cursed Crypt Map (Atlas of Worlds)|Map:Cursed Crypt Map (Atlas of Worlds)
Dark Forest Map (Atlas of Worlds)|Map:Dark Forest Map (Atlas of Worlds)
Death and Taxes (Atlas of Worlds)|Map:Death and Taxes (Atlas of Worlds)
Desert Map (Atlas of Worlds)|Map:Desert Map (Atlas of Worlds)
Desert Spring Map (Atlas of Worlds)|Map:Desert Spring Map (Atlas of Worlds)
Dunes Map (Atlas of Worlds)|Map:Dunes Map (Atlas of Worlds)
Dungeon Map (Atlas of Worlds)|Map:Dungeon Map (Atlas of Worlds)
Estuary Map (Atlas of Worlds)|Map:Estuary Map (Atlas of Worlds)
Excavation Map (Atlas of Worlds)|Map:Excavation Map (Atlas of Worlds)
Factory Map (Atlas of Worlds)|Map:Factory Map (Atlas of Worlds)
Flooded Mine Map (Atlas of Worlds)|Map:Flooded Mine Map (Atlas of Worlds)
Forge of the Phoenix Map (Atlas of Worlds)|Map:Forge of the Phoenix Map (Atlas of Worlds)
Fungal Hollow Map (Atlas of Worlds)|Map:Fungal Hollow Map (Atlas of Worlds)
Gardens Map (Atlas of Worlds)|Map:Gardens Map (Atlas of Worlds)
Geode Map (Atlas of Worlds)|Map:Geode Map (Atlas of Worlds)
Ghetto Map (Atlas of Worlds)|Map:Ghetto Map (Atlas of Worlds)
Glacier Map (Atlas of Worlds)|Map:Glacier Map (Atlas of Worlds)
Graveyard Map (Atlas of Worlds)|Map:Graveyard Map (Atlas of Worlds)
Grotto Map (Atlas of Worlds)|Map:Grotto Map (Atlas of Worlds)
Hall of Grandmasters (Atlas of Worlds)|Map:Hall of Grandmasters (Atlas of Worlds)
Harbinger Map (High Tier) (Atlas of Worlds)|Map:Harbinger Map (High Tier) (Atlas of Worlds)
Harbinger Map (Low Tier) (Atlas of Worlds)|Map:Harbinger Map (Low Tier) (Atlas of Worlds)
Harbinger Map (Mid Tier) (Atlas of Worlds)|Map:Harbinger Map (Mid Tier) (Atlas of Worlds)
Ivory Temple Map (Atlas of Worlds)|Map:Ivory Temple Map (Atlas of Worlds)
Jungle Valley Map (Atlas of Worlds)|Map:Jungle Valley Map (Atlas of Worlds)
Lair Map (Atlas of Worlds)|Map:Lair Map (Atlas of Worlds)
Lair of the Hydra Map (Atlas of Worlds)|Map:Lair of the Hydra Map (Atlas of Worlds)
Lava Chamber Map (Atlas of Worlds)|Map:Lava Chamber Map (Atlas of Worlds)
Leyline Map (Atlas of Worlds)|Map:Leyline Map (Atlas of Worlds)
Lighthouse Map (Atlas of Worlds)|Map:Lighthouse Map (Atlas of Worlds)
Malformation Map (Atlas of Worlds)|Map:Malformation Map (Atlas of Worlds)
Marshes Map (Atlas of Worlds)|Map:Marshes Map (Atlas of Worlds)
Maze Map (Atlas of Worlds)|Map:Maze Map (Atlas of Worlds)
Maze of the Minotaur Map (Atlas of Worlds)|Map:Maze of the Minotaur Map (Atlas of Worlds)
Mesa Map (Atlas of Worlds)|Map:Mesa Map (Atlas of Worlds)
Mineral Pools Map (Atlas of Worlds)|Map:Mineral Pools Map (Atlas of Worlds)
Mud Geyser Map (Atlas of Worlds)|Map:Mud Geyser Map (Atlas of Worlds)
Museum Map (Atlas of Worlds)|Map:Museum Map (Atlas of Worlds)
Necropolis Map (Atlas of Worlds)|Map:Necropolis Map (Atlas of Worlds)
Orchard Map (Atlas of Worlds)|Map:Orchard Map (Atlas of Worlds)
Overgrown Ruin Map (Atlas of Worlds)|Map:Overgrown Ruin Map (Atlas of Worlds)
Overgrown Shrine Map (Atlas of Worlds)|Map:Overgrown Shrine Map (Atlas of Worlds)
Palace Map (Atlas of Worlds)|Map:Palace Map (Atlas of Worlds)
Peninsula Map (Atlas of Worlds)|Map:Peninsula Map (Atlas of Worlds)
Phantasmagoria Map (Atlas of Worlds)|Map:Phantasmagoria Map (Atlas of Worlds)
Pier Map (Atlas of Worlds)|Map:Pier Map (Atlas of Worlds)
Pit Map (Atlas of Worlds)|Map:Pit Map (Atlas of Worlds)
Pit of the Chimera Map (Atlas of Worlds)|Map:Pit of the Chimera Map (Atlas of Worlds)
Plateau Map (Atlas of Worlds)|Map:Plateau Map (Atlas of Worlds)
Plaza Map (Atlas of Worlds)|Map:Plaza Map (Atlas of Worlds)
Port Map (Atlas of Worlds)|Map:Port Map (Atlas of Worlds)
Precinct Map (Atlas of Worlds)|Map:Precinct Map (Atlas of Worlds)
Primordial Blocks Map (Atlas of Worlds)|Map:Primordial Blocks Map (Atlas of Worlds)
Primordial Pool Map (Atlas of Worlds)|Map:Primordial Pool Map (Atlas of Worlds)
Promenade Map (Atlas of Worlds)|Map:Promenade Map (Atlas of Worlds)
Racecourse Map (Atlas of Worlds)|Map:Racecourse Map (Atlas of Worlds)
Ramparts Map (Atlas of Worlds)|Map:Ramparts Map (Atlas of Worlds)
Reef Map (Atlas of Worlds)|Map:Reef Map (Atlas of Worlds)
Residence Map (Atlas of Worlds)|Map:Residence Map (Atlas of Worlds)
Scriptorium Map (Atlas of Worlds)|Map:Scriptorium Map (Atlas of Worlds)
Shaped Academy Map (Atlas of Worlds)|Map:Shaped Academy Map (Atlas of Worlds)
Shaped Acid Caverns Map (Atlas of Worlds)|Map:Shaped Acid Caverns Map (Atlas of Worlds)
Shaped Ancient City Map (Atlas of Worlds)|Map:Shaped Ancient City Map (Atlas of Worlds)
Shaped Arachnid Nest Map (Atlas of Worlds)|Map:Shaped Arachnid Nest Map (Atlas of Worlds)
Shaped Arachnid Tomb Map (Atlas of Worlds)|Map:Shaped Arachnid Tomb Map (Atlas of Worlds)
Shaped Arcade Map (Atlas of Worlds)|Map:Shaped Arcade Map (Atlas of Worlds)
Shaped Arena Map (Atlas of Worlds)|Map:Shaped Arena Map (Atlas of Worlds)
Shaped Arid Lake Map (Atlas of Worlds)|Map:Shaped Arid Lake Map (Atlas of Worlds)
Shaped Armoury Map (Atlas of Worlds)|Map:Shaped Armoury Map (Atlas of Worlds)
Shaped Arsenal Map (Atlas of Worlds)|Map:Shaped Arsenal Map (Atlas of Worlds)
Shaped Ashen Wood Map (Atlas of Worlds)|Map:Shaped Ashen Wood Map (Atlas of Worlds)
Shaped Atoll Map (Atlas of Worlds)|Map:Shaped Atoll Map (Atlas of Worlds)
Shaped Barrows Map (Atlas of Worlds)|Map:Shaped Barrows Map (Atlas of Worlds)
Shaped Beach Map (Atlas of Worlds)|Map:Shaped Beach Map (Atlas of Worlds)
Shaped Bog Map (Atlas of Worlds)|Map:Shaped Bog Map (Atlas of Worlds)
Shaped Bone Crypt Map (Atlas of Worlds)|Map:Shaped Bone Crypt Map (Atlas of Worlds)
Shaped Burial Chambers Map (Atlas of Worlds)|Map:Shaped Burial Chambers Map (Atlas of Worlds)
Shaped Canyon Map (Atlas of Worlds)|Map:Shaped Canyon Map (Atlas of Worlds)
Shaped Castle Ruins Map (Atlas of Worlds)|Map:Shaped Castle Ruins Map (Atlas of Worlds)
Shaped Cells Map (Atlas of Worlds)|Map:Shaped Cells Map (Atlas of Worlds)
Shaped Cemetery Map (Atlas of Worlds)|Map:Shaped Cemetery Map (Atlas of Worlds)
Shaped Channel Map (Atlas of Worlds)|Map:Shaped Channel Map (Atlas of Worlds)
Shaped Colonnade Map (Atlas of Worlds)|Map:Shaped Colonnade Map (Atlas of Worlds)
Shaped Courtyard Map (Atlas of Worlds)|Map:Shaped Courtyard Map (Atlas of Worlds)
Shaped Coves Map (Atlas of Worlds)|Map:Shaped Coves Map (Atlas of Worlds)
Shaped Crystal Ore Map (Atlas of Worlds)|Map:Shaped Crystal Ore Map (Atlas of Worlds)
Shaped Cursed Crypt Map (Atlas of Worlds)|Map:Shaped Cursed Crypt Map (Atlas of Worlds)
Shaped Desert Map (Atlas of Worlds)|Map:Shaped Desert Map (Atlas of Worlds)
Shaped Desert Spring Map (Atlas of Worlds)|Map:Shaped Desert Spring Map (Atlas of Worlds)
Shaped Dunes Map (Atlas of Worlds)|Map:Shaped Dunes Map (Atlas of Worlds)
Shaped Dungeon Map (Atlas of Worlds)|Map:Shaped Dungeon Map (Atlas of Worlds)
Shaped Factory Map (Atlas of Worlds)|Map:Shaped Factory Map (Atlas of Worlds)
Shaped Flooded Mine Map (Atlas of Worlds)|Map:Shaped Flooded Mine Map (Atlas of Worlds)
Shaped Gardens Map (Atlas of Worlds)|Map:Shaped Gardens Map (Atlas of Worlds)
Shaped Geode Map (Atlas of Worlds)|Map:Shaped Geode Map (Atlas of Worlds)
Shaped Ghetto Map (Atlas of Worlds)|Map:Shaped Ghetto Map (Atlas of Worlds)
Shaped Graveyard Map (Atlas of Worlds)|Map:Shaped Graveyard Map (Atlas of Worlds)
Shaped Grotto Map (Atlas of Worlds)|Map:Shaped Grotto Map (Atlas of Worlds)
Shaped Jungle Valley Map (Atlas of Worlds)|Map:Shaped Jungle Valley Map (Atlas of Worlds)
Shaped Malformation Map (Atlas of Worlds)|Map:Shaped Malformation Map (Atlas of Worlds)
Shaped Marshes Map (Atlas of Worlds)|Map:Shaped Marshes Map (Atlas of Worlds)
Shaped Mesa Map (Atlas of Worlds)|Map:Shaped Mesa Map (Atlas of Worlds)
Shaped Mud Geyser Map (Atlas of Worlds)|Map:Shaped Mud Geyser Map (Atlas of Worlds)
Shaped Museum Map (Atlas of Worlds)|Map:Shaped Museum Map (Atlas of Worlds)
Shaped Orchard Map (Atlas of Worlds)|Map:Shaped Orchard Map (Atlas of Worlds)
Shaped Overgrown Shrine Map (Atlas of Worlds)|Map:Shaped Overgrown Shrine Map (Atlas of Worlds)
Shaped Peninsula Map (Atlas of Worlds)|Map:Shaped Peninsula Map (Atlas of Worlds)
Shaped Phantasmagoria Map (Atlas of Worlds)|Map:Shaped Phantasmagoria Map (Atlas of Worlds)
Shaped Pier Map (Atlas of Worlds)|Map:Shaped Pier Map (Atlas of Worlds)
Shaped Pit Map (Atlas of Worlds)|Map:Shaped Pit Map (Atlas of Worlds)
Shaped Port Map (Atlas of Worlds)|Map:Shaped Port Map (Atlas of Worlds)
Shaped Primordial Pool Map (Atlas of Worlds)|Map:Shaped Primordial Pool Map (Atlas of Worlds)
Shaped Promenade Map (Atlas of Worlds)|Map:Shaped Promenade Map (Atlas of Worlds)
Shaped Racecourse Map (Atlas of Worlds)|Map:Shaped Racecourse Map (Atlas of Worlds)
Shaped Ramparts Map (Atlas of Worlds)|Map:Shaped Ramparts Map (Atlas of Worlds)
Shaped Reef Map (Atlas of Worlds)|Map:Shaped Reef Map (Atlas of Worlds)
Shaped Shore Map (Atlas of Worlds)|Map:Shaped Shore Map (Atlas of Worlds)
Shaped Spider Forest Map (Atlas of Worlds)|Map:Shaped Spider Forest Map (Atlas of Worlds)
Shaped Spider Lair Map (Atlas of Worlds)|Map:Shaped Spider Lair Map (Atlas of Worlds)
Shaped Strand Map (Atlas of Worlds)|Map:Shaped Strand Map (Atlas of Worlds)
Shaped Temple Map (Atlas of Worlds)|Map:Shaped Temple Map (Atlas of Worlds)
Shaped Thicket Map (Atlas of Worlds)|Map:Shaped Thicket Map (Atlas of Worlds)
Shaped Tower Map (Atlas of Worlds)|Map:Shaped Tower Map (Atlas of Worlds)
Shaped Toxic Sewer Map (Atlas of Worlds)|Map:Shaped Toxic Sewer Map (Atlas of Worlds)
Shaped Tropical Island Map (Atlas of Worlds)|Map:Shaped Tropical Island Map (Atlas of Worlds)
Shaped Underground River Map (Atlas of Worlds)|Map:Shaped Underground River Map (Atlas of Worlds)
Shaped Vaal Pyramid Map (Atlas of Worlds)|Map:Shaped Vaal Pyramid Map (Atlas of Worlds)
Shaped Villa Map (Atlas of Worlds)|Map:Shaped Villa Map (Atlas of Worlds)
Shaped Waste Pool Map (Atlas of Worlds)|Map:Shaped Waste Pool Map (Atlas of Worlds)
Shaped Wharf Map (Atlas of Worlds)|Map:Shaped Wharf Map (Atlas of Worlds)
Shipyard Map (Atlas of Worlds)|Map:Shipyard Map (Atlas of Worlds)
Shore Map (Atlas of Worlds)|Map:Shore Map (Atlas of Worlds)
Shrine Map (Atlas of Worlds)|Map:Shrine Map (Atlas of Worlds)
Spider Forest Map (Atlas of Worlds)|Map:Spider Forest Map (Atlas of Worlds)
Spider Lair Map (Atlas of Worlds)|Map:Spider Lair Map (Atlas of Worlds)
Strand Map (Atlas of Worlds)|Map:Strand Map (Atlas of Worlds)
Temple Map (Atlas of Worlds)|Map:Temple Map (Atlas of Worlds)
Terrace Map (Atlas of Worlds)|Map:Terrace Map (Atlas of Worlds)
The Coward's Trial (Atlas of Worlds)|Map:The Coward's Trial (Atlas of Worlds)
The Shaper's Realm (Atlas of Worlds)|Map:The Shaper's Realm (Atlas of Worlds)
Thicket Map (Atlas of Worlds)|Map:Thicket Map (Atlas of Worlds)
Tower Map (Atlas of Worlds)|Map:Tower Map (Atlas of Worlds)
Toxic Sewer Map (Atlas of Worlds)|Map:Toxic Sewer Map (Atlas of Worlds)
Tropical Island Map (Atlas of Worlds)|Map:Tropical Island Map (Atlas of Worlds)
Underground River Map (Atlas of Worlds)|Map:Underground River Map (Atlas of Worlds)
Underground Sea Map (Atlas of Worlds)|Map:Underground Sea Map (Atlas of Worlds)
Vaal Pyramid Map (Atlas of Worlds)|Map:Vaal Pyramid Map (Atlas of Worlds)
Vaal Temple Map (Atlas of Worlds)|Map:Vaal Temple Map (Atlas of Worlds)
Vault Map (Atlas of Worlds)|Map:Vault Map (Atlas of Worlds)
Villa Map (Atlas of Worlds)|Map:Villa Map (Atlas of Worlds)
Volcano Map (Atlas of Worlds)|Map:Volcano Map (Atlas of Worlds)
Waste Pool Map (Atlas of Worlds)|Map:Waste Pool Map (Atlas of Worlds)
Wasteland Map (Atlas of Worlds)|Map:Wasteland Map (Atlas of Worlds)
Waterways Map (Atlas of Worlds)|Map:Waterways Map (Atlas of Worlds)
Wharf Map (Atlas of Worlds)|Map:Wharf Map (Atlas of Worlds)
Academy Map (War for the Atlas)|Map:Academy Map (War for the Atlas)
Acid Caverns Map (War for the Atlas)|Map:Acid Caverns Map (War for the Atlas)
Acton's Nightmare (War for the Atlas)|Map:Acton's Nightmare (War for the Atlas)
Alleyways Map (War for the Atlas)|Map:Alleyways Map (War for the Atlas)
Ancient City Map (War for the Atlas)|Map:Ancient City Map (War for the Atlas)
Arachnid Nest Map (War for the Atlas)|Map:Arachnid Nest Map (War for the Atlas)
Arachnid Tomb Map (War for the Atlas)|Map:Arachnid Tomb Map (War for the Atlas)
Arcade Map (War for the Atlas)|Map:Arcade Map (War for the Atlas)
Arena Map (War for the Atlas)|Map:Arena Map (War for the Atlas)
Arid Lake Map (War for the Atlas)|Map:Arid Lake Map (War for the Atlas)
Armoury Map (War for the Atlas)|Map:Armoury Map (War for the Atlas)
Arsenal Map (War for the Atlas)|Map:Arsenal Map (War for the Atlas)
Ashen Wood Map (War for the Atlas)|Map:Ashen Wood Map (War for the Atlas)
Atoll Map (War for the Atlas)|Map:Atoll Map (War for the Atlas)
Barrows Map (War for the Atlas)|Map:Barrows Map (War for the Atlas)
Basilica Map (War for the Atlas)|Map:Basilica Map (War for the Atlas)
Bazaar Map (War for the Atlas)|Map:Bazaar Map (War for the Atlas)
Beach Map (War for the Atlas)|Map:Beach Map (War for the Atlas)
Belfry Map (War for the Atlas)|Map:Belfry Map (War for the Atlas)
Bog Map (War for the Atlas)|Map:Bog Map (War for the Atlas)
Bone Crypt Map (War for the Atlas)|Map:Bone Crypt Map (War for the Atlas)
Burial Chambers Map (War for the Atlas)|Map:Burial Chambers Map (War for the Atlas)
Caer Blaidd, Wolfpack's Den (War for the Atlas)|Map:Caer Blaidd, Wolfpack's Den (War for the Atlas)
Cage Map (War for the Atlas)|Map:Cage Map (War for the Atlas)
Caldera Map (War for the Atlas)|Map:Caldera Map (War for the Atlas)
Canyon Map (War for the Atlas)|Map:Canyon Map (War for the Atlas)
Carcass Map (War for the Atlas)|Map:Carcass Map (War for the Atlas)
Castle Ruins Map (War for the Atlas)|Map:Castle Ruins Map (War for the Atlas)
Cells Map (War for the Atlas)|Map:Cells Map (War for the Atlas)
Cemetery Map (War for the Atlas)|Map:Cemetery Map (War for the Atlas)
Channel Map (War for the Atlas)|Map:Channel Map (War for the Atlas)
Chateau Map (War for the Atlas)|Map:Chateau Map (War for the Atlas)
City Square Map (War for the Atlas)|Map:City Square Map (War for the Atlas)
Colonnade Map (War for the Atlas)|Map:Colonnade Map (War for the Atlas)
Colosseum Map (War for the Atlas)|Map:Colosseum Map (War for the Atlas)
Conservatory Map (War for the Atlas)|Map:Conservatory Map (War for the Atlas)
Coral Ruins Map (War for the Atlas)|Map:Coral Ruins Map (War for the Atlas)
Core Map (War for the Atlas)|Map:Core Map (War for the Atlas)
Courthouse Map (War for the Atlas)|Map:Courthouse Map (War for the Atlas)
Courtyard Map (War for the Atlas)|Map:Courtyard Map (War for the Atlas)
Coves Map (War for the Atlas)|Map:Coves Map (War for the Atlas)
Crater Map (War for the Atlas)|Map:Crater Map (War for the Atlas)
Crimson Temple Map (War for the Atlas)|Map:Crimson Temple Map (War for the Atlas)
Crystal Ore Map (War for the Atlas)|Map:Crystal Ore Map (War for the Atlas)
Cursed Crypt Map (War for the Atlas)|Map:Cursed Crypt Map (War for the Atlas)
Dark Forest Map (War for the Atlas)|Map:Dark Forest Map (War for the Atlas)
Death and Taxes (War for the Atlas)|Map:Death and Taxes (War for the Atlas)
Defiled Cathedral Map (War for the Atlas)|Map:Defiled Cathedral Map (War for the Atlas)
Desert Map (War for the Atlas)|Map:Desert Map (War for the Atlas)
Desert Spring Map (War for the Atlas)|Map:Desert Spring Map (War for the Atlas)
Dig Map (War for the Atlas)|Map:Dig Map (War for the Atlas)
Dunes Map (War for the Atlas)|Map:Dunes Map (War for the Atlas)
Dungeon Map (War for the Atlas)|Map:Dungeon Map (War for the Atlas)
Estuary Map (War for the Atlas)|Map:Estuary Map (War for the Atlas)
Excavation Map (War for the Atlas)|Map:Excavation Map (War for the Atlas)
Factory Map (War for the Atlas)|Map:Factory Map (War for the Atlas)
Fields Map (War for the Atlas)|Map:Fields Map (War for the Atlas)
Flooded Mine Map (War for the Atlas)|Map:Flooded Mine Map (War for the Atlas)
Forge of the Phoenix Map (War for the Atlas)|Map:Forge of the Phoenix Map (War for the Atlas)
Fungal Hollow Map (War for the Atlas)|Map:Fungal Hollow Map (War for the Atlas)
Gardens Map (War for the Atlas)|Map:Gardens Map (War for the Atlas)
Geode Map (War for the Atlas)|Map:Geode Map (War for the Atlas)
Ghetto Map (War for the Atlas)|Map:Ghetto Map (War for the Atlas)
Glacier Map (War for the Atlas)|Map:Glacier Map (War for the Atlas)
Graveyard Map (War for the Atlas)|Map:Graveyard Map (War for the Atlas)
Grotto Map (War for the Atlas)|Map:Grotto Map (War for the Atlas)
Hall of Grandmasters (War for the Atlas)|Map:Hall of Grandmasters (War for the Atlas)
Harbinger Map (High Tier) (War for the Atlas)|Map:Harbinger Map (High Tier) (War for the Atlas)
Harbinger Map (Low Tier) (War for the Atlas)|Map:Harbinger Map (Low Tier) (War for the Atlas)
Harbinger Map (Mid Tier) (War for the Atlas)|Map:Harbinger Map (Mid Tier) (War for the Atlas)
Haunted Mansion Map (War for the Atlas)|Map:Haunted Mansion Map (War for the Atlas)
Iceberg Map (War for the Atlas)|Map:Iceberg Map (War for the Atlas)
Infested Valley Map (War for the Atlas)|Map:Infested Valley Map (War for the Atlas)
Ivory Temple Map (War for the Atlas)|Map:Ivory Temple Map (War for the Atlas)
Jungle Valley Map (War for the Atlas)|Map:Jungle Valley Map (War for the Atlas)
Laboratory Map (War for the Atlas)|Map:Laboratory Map (War for the Atlas)
Lair Map (War for the Atlas)|Map:Lair Map (War for the Atlas)
Lair of the Hydra Map (War for the Atlas)|Map:Lair of the Hydra Map (War for the Atlas)
Lava Chamber Map (War for the Atlas)|Map:Lava Chamber Map (War for the Atlas)
Lava Lake Map (War for the Atlas)|Map:Lava Lake Map (War for the Atlas)
Leyline Map (War for the Atlas)|Map:Leyline Map (War for the Atlas)
Lighthouse Map (War for the Atlas)|Map:Lighthouse Map (War for the Atlas)
Lookout Map (War for the Atlas)|Map:Lookout Map (War for the Atlas)
Malformation Map (War for the Atlas)|Map:Malformation Map (War for the Atlas)
Marshes Map (War for the Atlas)|Map:Marshes Map (War for the Atlas)
Mausoleum Map (War for the Atlas)|Map:Mausoleum Map (War for the Atlas)
Maze Map (War for the Atlas)|Map:Maze Map (War for the Atlas)
Maze of the Minotaur Map (War for the Atlas)|Map:Maze of the Minotaur Map (War for the Atlas)
Mesa Map (War for the Atlas)|Map:Mesa Map (War for the Atlas)
Mineral Pools Map (War for the Atlas)|Map:Mineral Pools Map (War for the Atlas)
Moon Temple Map (War for the Atlas)|Map:Moon Temple Map (War for the Atlas)
Mud Geyser Map (War for the Atlas)|Map:Mud Geyser Map (War for the Atlas)
Museum Map (War for the Atlas)|Map:Museum Map (War for the Atlas)
Necropolis Map (War for the Atlas)|Map:Necropolis Map (War for the Atlas)
Orchard Map (War for the Atlas)|Map:Orchard Map (War for the Atlas)
Overgrown Ruin Map (War for the Atlas)|Map:Overgrown Ruin Map (War for the Atlas)
Overgrown Shrine Map (War for the Atlas)|Map:Overgrown Shrine Map (War for the Atlas)
Palace Map (War for the Atlas)|Map:Palace Map (War for the Atlas)
Park Map (War for the Atlas)|Map:Park Map (War for the Atlas)
Pen Map (War for the Atlas)|Map:Pen Map (War for the Atlas)
Peninsula Map (War for the Atlas)|Map:Peninsula Map (War for the Atlas)
Phantasmagoria Map (War for the Atlas)|Map:Phantasmagoria Map (War for the Atlas)
Pier Map (War for the Atlas)|Map:Pier Map (War for the Atlas)
Pit Map (War for the Atlas)|Map:Pit Map (War for the Atlas)
Pit of the Chimera Map (War for the Atlas)|Map:Pit of the Chimera Map (War for the Atlas)
Plateau Map (War for the Atlas)|Map:Plateau Map (War for the Atlas)
Plaza Map (War for the Atlas)|Map:Plaza Map (War for the Atlas)
Port Map (War for the Atlas)|Map:Port Map (War for the Atlas)
Precinct Map (War for the Atlas)|Map:Precinct Map (War for the Atlas)
Primordial Blocks Map (War for the Atlas)|Map:Primordial Blocks Map (War for the Atlas)
Primordial Pool Map (War for the Atlas)|Map:Primordial Pool Map (War for the Atlas)
Promenade Map (War for the Atlas)|Map:Promenade Map (War for the Atlas)
Racecourse Map (War for the Atlas)|Map:Racecourse Map (War for the Atlas)
Ramparts Map (War for the Atlas)|Map:Ramparts Map (War for the Atlas)
Reef Map (War for the Atlas)|Map:Reef Map (War for the Atlas)
Relic Chambers Map (War for the Atlas)|Map:Relic Chambers Map (War for the Atlas)
Residence Map (War for the Atlas)|Map:Residence Map (War for the Atlas)
Scriptorium Map (War for the Atlas)|Map:Scriptorium Map (War for the Atlas)
Sepulchre Map (War for the Atlas)|Map:Sepulchre Map (War for the Atlas)
Shipyard Map (War for the Atlas)|Map:Shipyard Map (War for the Atlas)
Shore Map (War for the Atlas)|Map:Shore Map (War for the Atlas)
Shrine Map (War for the Atlas)|Map:Shrine Map (War for the Atlas)
Siege Map (War for the Atlas)|Map:Siege Map (War for the Atlas)
Spider Forest Map (War for the Atlas)|Map:Spider Forest Map (War for the Atlas)
Spider Lair Map (War for the Atlas)|Map:Spider Lair Map (War for the Atlas)
Strand Map (War for the Atlas)|Map:Strand Map (War for the Atlas)
Sulphur Vents Map (War for the Atlas)|Map:Sulphur Vents Map (War for the Atlas)
Summit Map (War for the Atlas)|Map:Summit Map (War for the Atlas)
Sunken City Map (War for the Atlas)|Map:Sunken City Map (War for the Atlas)
Temple Map (War for the Atlas)|Map:Temple Map (War for the Atlas)
Terrace Map (War for the Atlas)|Map:Terrace Map (War for the Atlas)
The Coward's Trial (War for the Atlas)|Map:The Coward's Trial (War for the Atlas)
The Shaper's Realm (War for the Atlas)|Map:The Shaper's Realm (War for the Atlas)
Thicket Map (War for the Atlas)|Map:Thicket Map (War for the Atlas)
Tower Map (War for the Atlas)|Map:Tower Map (War for the Atlas)
Toxic Sewer Map (War for the Atlas)|Map:Toxic Sewer Map (War for the Atlas)
Tropical Island Map (War for the Atlas)|Map:Tropical Island Map (War for the Atlas)
Underground River Map (War for the Atlas)|Map:Underground River Map (War for the Atlas)
Underground Sea Map (War for the Atlas)|Map:Underground Sea Map (War for the Atlas)
Vaal Pyramid Map (War for the Atlas)|Map:Vaal Pyramid Map (War for the Atlas)
Vaal Temple Map (War for the Atlas)|Map:Vaal Temple Map (War for the Atlas)
Vault Map (War for the Atlas)|Map:Vault Map (War for the Atlas)
Villa Map (War for the Atlas)|Map:Villa Map (War for the Atlas)
Volcano Map (War for the Atlas)|Map:Volcano Map (War for the Atlas)
Waste Pool Map (War for the Atlas)|Map:Waste Pool Map (War for the Atlas)
Wasteland Map (War for the Atlas)|Map:Wasteland Map (War for the Atlas)
Waterways Map (War for the Atlas)|Map:Waterways Map (War for the Atlas)
Wharf Map (War for the Atlas)|Map:Wharf Map (War for the Atlas)
Academy Map (Betrayal)|Map:Academy Map (Betrayal)
Acid Caverns Map (Betrayal)|Map:Acid Caverns Map (Betrayal)
Alleyways Map (Betrayal)|Map:Alleyways Map (Betrayal)
Ancient City Map (Betrayal)|Map:Ancient City Map (Betrayal)
Arachnid Nest Map (Betrayal)|Map:Arachnid Nest Map (Betrayal)
Arachnid Tomb Map (Betrayal)|Map:Arachnid Tomb Map (Betrayal)
Arcade Map (Betrayal)|Map:Arcade Map (Betrayal)
Arena Map (Betrayal)|Map:Arena Map (Betrayal)
Arid Lake Map (Betrayal)|Map:Arid Lake Map (Betrayal)
Armoury Map (Betrayal)|Map:Armoury Map (Betrayal)
Arsenal Map (Betrayal)|Map:Arsenal Map (Betrayal)
Ashen Wood Map (Betrayal)|Map:Ashen Wood Map (Betrayal)
Atoll Map (Betrayal)|Map:Atoll Map (Betrayal)
Barrows Map (Betrayal)|Map:Barrows Map (Betrayal)
Basilica Map (Betrayal)|Map:Basilica Map (Betrayal)
Bazaar Map (Betrayal)|Map:Bazaar Map (Betrayal)
Beach Map (Betrayal)|Map:Beach Map (Betrayal)
Belfry Map (Betrayal)|Map:Belfry Map (Betrayal)
Bog Map (Betrayal)|Map:Bog Map (Betrayal)
Bone Crypt Map (Betrayal)|Map:Bone Crypt Map (Betrayal)
Burial Chambers Map (Betrayal)|Map:Burial Chambers Map (Betrayal)
Cage Map (Betrayal)|Map:Cage Map (Betrayal)
Caldera Map (Betrayal)|Map:Caldera Map (Betrayal)
Canyon Map (Betrayal)|Map:Canyon Map (Betrayal)
Carcass Map (Betrayal)|Map:Carcass Map (Betrayal)
Castle Ruins Map (Betrayal)|Map:Castle Ruins Map (Betrayal)
Cells Map (Betrayal)|Map:Cells Map (Betrayal)
Cemetery Map (Betrayal)|Map:Cemetery Map (Betrayal)
Channel Map (Betrayal)|Map:Channel Map (Betrayal)
Chateau Map (Betrayal)|Map:Chateau Map (Betrayal)
City Square Map (Betrayal)|Map:City Square Map (Betrayal)
Colonnade Map (Betrayal)|Map:Colonnade Map (Betrayal)
Colosseum Map (Betrayal)|Map:Colosseum Map (Betrayal)
Conservatory Map (Betrayal)|Map:Conservatory Map (Betrayal)
Coral Ruins Map (Betrayal)|Map:Coral Ruins Map (Betrayal)
Core Map (Betrayal)|Map:Core Map (Betrayal)
Courthouse Map (Betrayal)|Map:Courthouse Map (Betrayal)
Courtyard Map (Betrayal)|Map:Courtyard Map (Betrayal)
Coves Map (Betrayal)|Map:Coves Map (Betrayal)
Crater Map (Betrayal)|Map:Crater Map (Betrayal)
Crimson Temple Map (Betrayal)|Map:Crimson Temple Map (Betrayal)
Crystal Ore Map (Betrayal)|Map:Crystal Ore Map (Betrayal)
Cursed Crypt Map (Betrayal)|Map:Cursed Crypt Map (Betrayal)
Dark Forest Map (Betrayal)|Map:Dark Forest Map (Betrayal)
Defiled Cathedral Map (Betrayal)|Map:Defiled Cathedral Map (Betrayal)
Desert Map (Betrayal)|Map:Desert Map (Betrayal)
Desert Spring Map (Betrayal)|Map:Desert Spring Map (Betrayal)
Dig Map (Betrayal)|Map:Dig Map (Betrayal)
Dunes Map (Betrayal)|Map:Dunes Map (Betrayal)
Dungeon Map (Betrayal)|Map:Dungeon Map (Betrayal)
Estuary Map (Betrayal)|Map:Estuary Map (Betrayal)
Excavation Map (Betrayal)|Map:Excavation Map (Betrayal)
Factory Map (Betrayal)|Map:Factory Map (Betrayal)
Fields Map (Betrayal)|Map:Fields Map (Betrayal)
Flooded Mine Map (Betrayal)|Map:Flooded Mine Map (Betrayal)
Forge of the Phoenix Map (Betrayal)|Map:Forge of the Phoenix Map (Betrayal)
Fungal Hollow Map (Betrayal)|Map:Fungal Hollow Map (Betrayal)
Gardens Map (Betrayal)|Map:Gardens Map (Betrayal)
Geode Map (Betrayal)|Map:Geode Map (Betrayal)
Ghetto Map (Betrayal)|Map:Ghetto Map (Betrayal)
Glacier Map (Betrayal)|Map:Glacier Map (Betrayal)
Graveyard Map (Betrayal)|Map:Graveyard Map (Betrayal)
Grotto Map (Betrayal)|Map:Grotto Map (Betrayal)
Harbinger Map (Low Tier) (Betrayal)|Map:Harbinger Map (Low Tier) (Betrayal)
Haunted Mansion Map (Betrayal)|Map:Haunted Mansion Map (Betrayal)
Iceberg Map (Betrayal)|Map:Iceberg Map (Betrayal)
Infested Valley Map (Betrayal)|Map:Infested Valley Map (Betrayal)
Ivory Temple Map (Betrayal)|Map:Ivory Temple Map (Betrayal)
Jungle Valley Map (Betrayal)|Map:Jungle Valley Map (Betrayal)
Laboratory Map (Betrayal)|Map:Laboratory Map (Betrayal)
Lair Map (Betrayal)|Map:Lair Map (Betrayal)
Lair of the Hydra Map (Betrayal)|Map:Lair of the Hydra Map (Betrayal)
Lava Chamber Map (Betrayal)|Map:Lava Chamber Map (Betrayal)
Lava Lake Map (Betrayal)|Map:Lava Lake Map (Betrayal)
Leyline Map (Betrayal)|Map:Leyline Map (Betrayal)
Lighthouse Map (Betrayal)|Map:Lighthouse Map (Betrayal)
Lookout Map (Betrayal)|Map:Lookout Map (Betrayal)
Malformation Map (Betrayal)|Map:Malformation Map (Betrayal)
Marshes Map (Betrayal)|Map:Marshes Map (Betrayal)
Mausoleum Map (Betrayal)|Map:Mausoleum Map (Betrayal)
Maze Map (Betrayal)|Map:Maze Map (Betrayal)
Maze of the Minotaur Map (Betrayal)|Map:Maze of the Minotaur Map (Betrayal)
Mesa Map (Betrayal)|Map:Mesa Map (Betrayal)
Mineral Pools Map (Betrayal)|Map:Mineral Pools Map (Betrayal)
Moon Temple Map (Betrayal)|Map:Moon Temple Map (Betrayal)
Mud Geyser Map (Betrayal)|Map:Mud Geyser Map (Betrayal)
Museum Map (Betrayal)|Map:Museum Map (Betrayal)
Necropolis Map (Betrayal)|Map:Necropolis Map (Betrayal)
Orchard Map (Betrayal)|Map:Orchard Map (Betrayal)
Overgrown Ruin Map (Betrayal)|Map:Overgrown Ruin Map (Betrayal)
Overgrown Shrine Map (Betrayal)|Map:Overgrown Shrine Map (Betrayal)
Palace Map (Betrayal)|Map:Palace Map (Betrayal)
Park Map (Betrayal)|Map:Park Map (Betrayal)
Pen Map (Betrayal)|Map:Pen Map (Betrayal)
Peninsula Map (Betrayal)|Map:Peninsula Map (Betrayal)
Phantasmagoria Map (Betrayal)|Map:Phantasmagoria Map (Betrayal)
Pier Map (Betrayal)|Map:Pier Map (Betrayal)
Pit Map (Betrayal)|Map:Pit Map (Betrayal)
Pit of the Chimera Map (Betrayal)|Map:Pit of the Chimera Map (Betrayal)
Plateau Map (Betrayal)|Map:Plateau Map (Betrayal)
Plaza Map (Betrayal)|Map:Plaza Map (Betrayal)
Port Map (Betrayal)|Map:Port Map (Betrayal)
Precinct Map (Betrayal)|Map:Precinct Map (Betrayal)
Primordial Blocks Map (Betrayal)|Map:Primordial Blocks Map (Betrayal)
Primordial Pool Map (Betrayal)|Map:Primordial Pool Map (Betrayal)
Promenade Map (Betrayal)|Map:Promenade Map (Betrayal)
Racecourse Map (Betrayal)|Map:Racecourse Map (Betrayal)
Ramparts Map (Betrayal)|Map:Ramparts Map (Betrayal)
Reef Map (Betrayal)|Map:Reef Map (Betrayal)
Relic Chambers Map (Betrayal)|Map:Relic Chambers Map (Betrayal)
Residence Map (Betrayal)|Map:Residence Map (Betrayal)
Scriptorium Map (Betrayal)|Map:Scriptorium Map (Betrayal)
Sepulchre Map (Betrayal)|Map:Sepulchre Map (Betrayal)
Shipyard Map (Betrayal)|Map:Shipyard Map (Betrayal)
Shore Map (Betrayal)|Map:Shore Map (Betrayal)
Shrine Map (Betrayal)|Map:Shrine Map (Betrayal)
Siege Map (Betrayal)|Map:Siege Map (Betrayal)
Spider Forest Map (Betrayal)|Map:Spider Forest Map (Betrayal)
Spider Lair Map (Betrayal)|Map:Spider Lair Map (Betrayal)
Strand Map (Betrayal)|Map:Strand Map (Betrayal)
Sulphur Vents Map (Betrayal)|Map:Sulphur Vents Map (Betrayal)
Summit Map (Betrayal)|Map:Summit Map (Betrayal)
Sunken City Map (Betrayal)|Map:Sunken City Map (Betrayal)
Temple Map (Betrayal)|Map:Temple Map (Betrayal)
Terrace Map (Betrayal)|Map:Terrace Map (Betrayal)
The Coward's Trial (Betrayal)|Map:The Coward's Trial (Betrayal)
The Shaper's Realm (Betrayal)|Map:The Shaper's Realm (Betrayal)
Thicket Map (Betrayal)|Map:Thicket Map (Betrayal)
Tower Map (Betrayal)|Map:Tower Map (Betrayal)
Toxic Sewer Map (Betrayal)|Map:Toxic Sewer Map (Betrayal)
Tropical Island Map (Betrayal)|Map:Tropical Island Map (Betrayal)
Underground River Map (Betrayal)|Map:Underground River Map (Betrayal)
Underground Sea Map (Betrayal)|Map:Underground Sea Map (Betrayal)
Vaal Pyramid Map (Betrayal)|Map:Vaal Pyramid Map (Betrayal)
Vaal Temple Map (Betrayal)|Map:Vaal Temple Map (Betrayal)
Vault Map (Betrayal)|Map:Vault Map (Betrayal)
Villa Map (Betrayal)|Map:Villa Map (Betrayal)
Volcano Map (Betrayal)|Map:Volcano Map (Betrayal)
Waste Pool Map (Betrayal)|Map:Waste Pool Map (Betrayal)
Wasteland Map (Betrayal)|Map:Wasteland Map (Betrayal)
Waterways Map (Betrayal)|Map:Waterways Map (Betrayal)
Wharf Map (Betrayal)|Map:Wharf Map (Betrayal)
Academy Map (Synthesis)|Map:Academy Map (Synthesis)
Acid Caverns Map (Synthesis)|Map:Acid Caverns Map (Synthesis)
Alleyways Map (Synthesis)|Map:Alleyways Map (Synthesis)
Ancient City Map (Synthesis)|Map:Ancient City Map (Synthesis)
Arachnid Nest Map (Synthesis)|Map:Arachnid Nest Map (Synthesis)
Arachnid Tomb Map (Synthesis)|Map:Arachnid Tomb Map (Synthesis)
Arcade Map (Synthesis)|Map:Arcade Map (Synthesis)
Arena Map (Synthesis)|Map:Arena Map (Synthesis)
Arid Lake Map (Synthesis)|Map:Arid Lake Map (Synthesis)
Armoury Map (Synthesis)|Map:Armoury Map (Synthesis)
Arsenal Map (Synthesis)|Map:Arsenal Map (Synthesis)
Ashen Wood Map (Synthesis)|Map:Ashen Wood Map (Synthesis)
Atoll Map (Synthesis)|Map:Atoll Map (Synthesis)
Barrows Map (Synthesis)|Map:Barrows Map (Synthesis)
Basilica Map (Synthesis)|Map:Basilica Map (Synthesis)
Bazaar Map (Synthesis)|Map:Bazaar Map (Synthesis)
Beach Map (Synthesis)|Map:Beach Map (Synthesis)
Belfry Map (Synthesis)|Map:Belfry Map (Synthesis)
Bog Map (Synthesis)|Map:Bog Map (Synthesis)
Bone Crypt Map (Synthesis)|Map:Bone Crypt Map (Synthesis)
Burial Chambers Map (Synthesis)|Map:Burial Chambers Map (Synthesis)
Cage Map (Synthesis)|Map:Cage Map (Synthesis)
Caldera Map (Synthesis)|Map:Caldera Map (Synthesis)
Canyon Map (Synthesis)|Map:Canyon Map (Synthesis)
Carcass Map (Synthesis)|Map:Carcass Map (Synthesis)
Castle Ruins Map (Synthesis)|Map:Castle Ruins Map (Synthesis)
Cells Map (Synthesis)|Map:Cells Map (Synthesis)
Cemetery Map (Synthesis)|Map:Cemetery Map (Synthesis)
Channel Map (Synthesis)|Map:Channel Map (Synthesis)
Chateau Map (Synthesis)|Map:Chateau Map (Synthesis)
City Square Map (Synthesis)|Map:City Square Map (Synthesis)
Colonnade Map (Synthesis)|Map:Colonnade Map (Synthesis)
Colosseum Map (Synthesis)|Map:Colosseum Map (Synthesis)
Conservatory Map (Synthesis)|Map:Conservatory Map (Synthesis)
Coral Ruins Map (Synthesis)|Map:Coral Ruins Map (Synthesis)
Core Map (Synthesis)|Map:Core Map (Synthesis)
Courthouse Map (Synthesis)|Map:Courthouse Map (Synthesis)
Courtyard Map (Synthesis)|Map:Courtyard Map (Synthesis)
Coves Map (Synthesis)|Map:Coves Map (Synthesis)
Crater Map (Synthesis)|Map:Crater Map (Synthesis)
Crimson Temple Map (Synthesis)|Map:Crimson Temple Map (Synthesis)
Crystal Ore Map (Synthesis)|Map:Crystal Ore Map (Synthesis)
Cursed Crypt Map (Synthesis)|Map:Cursed Crypt Map (Synthesis)
Dark Forest Map (Synthesis)|Map:Dark Forest Map (Synthesis)
Defiled Cathedral Map (Synthesis)|Map:Defiled Cathedral Map (Synthesis)
Desert Map (Synthesis)|Map:Desert Map (Synthesis)
Desert Spring Map (Synthesis)|Map:Desert Spring Map (Synthesis)
Dig Map (Synthesis)|Map:Dig Map (Synthesis)
Dunes Map (Synthesis)|Map:Dunes Map (Synthesis)
Dungeon Map (Synthesis)|Map:Dungeon Map (Synthesis)
Estuary Map (Synthesis)|Map:Estuary Map (Synthesis)
Excavation Map (Synthesis)|Map:Excavation Map (Synthesis)
Factory Map (Synthesis)|Map:Factory Map (Synthesis)
Fields Map (Synthesis)|Map:Fields Map (Synthesis)
Flooded Mine Map (Synthesis)|Map:Flooded Mine Map (Synthesis)
Forge of the Phoenix Map (Synthesis)|Map:Forge of the Phoenix Map (Synthesis)
Fungal Hollow Map (Synthesis)|Map:Fungal Hollow Map (Synthesis)
Gardens Map (Synthesis)|Map:Gardens Map (Synthesis)
Geode Map (Synthesis)|Map:Geode Map (Synthesis)
Ghetto Map (Synthesis)|Map:Ghetto Map (Synthesis)
Glacier Map (Synthesis)|Map:Glacier Map (Synthesis)
Graveyard Map (Synthesis)|Map:Graveyard Map (Synthesis)
Grotto Map (Synthesis)|Map:Grotto Map (Synthesis)
Harbinger Map (Low Tier) (Synthesis)|Map:Harbinger Map (Low Tier) (Synthesis)
Haunted Mansion Map (Synthesis)|Map:Haunted Mansion Map (Synthesis)
Iceberg Map (Synthesis)|Map:Iceberg Map (Synthesis)
Infested Valley Map (Synthesis)|Map:Infested Valley Map (Synthesis)
Ivory Temple Map (Synthesis)|Map:Ivory Temple Map (Synthesis)
Jungle Valley Map (Synthesis)|Map:Jungle Valley Map (Synthesis)
Laboratory Map (Synthesis)|Map:Laboratory Map (Synthesis)
Lair Map (Synthesis)|Map:Lair Map (Synthesis)
Lair of the Hydra Map (Synthesis)|Map:Lair of the Hydra Map (Synthesis)
Lava Chamber Map (Synthesis)|Map:Lava Chamber Map (Synthesis)
Lava Lake Map (Synthesis)|Map:Lava Lake Map (Synthesis)
Leyline Map (Synthesis)|Map:Leyline Map (Synthesis)
Lighthouse Map (Synthesis)|Map:Lighthouse Map (Synthesis)
Lookout Map (Synthesis)|Map:Lookout Map (Synthesis)
Malformation Map (Synthesis)|Map:Malformation Map (Synthesis)
Marshes Map (Synthesis)|Map:Marshes Map (Synthesis)
Mausoleum Map (Synthesis)|Map:Mausoleum Map (Synthesis)
Maze Map (Synthesis)|Map:Maze Map (Synthesis)
Maze of the Minotaur Map (Synthesis)|Map:Maze of the Minotaur Map (Synthesis)
Mesa Map (Synthesis)|Map:Mesa Map (Synthesis)
Mineral Pools Map (Synthesis)|Map:Mineral Pools Map (Synthesis)
Moon Temple Map (Synthesis)|Map:Moon Temple Map (Synthesis)
Mud Geyser Map (Synthesis)|Map:Mud Geyser Map (Synthesis)
Museum Map (Synthesis)|Map:Museum Map (Synthesis)
Necropolis Map (Synthesis)|Map:Necropolis Map (Synthesis)
Orchard Map (Synthesis)|Map:Orchard Map (Synthesis)
Overgrown Ruin Map (Synthesis)|Map:Overgrown Ruin Map (Synthesis)
Overgrown Shrine Map (Synthesis)|Map:Overgrown Shrine Map (Synthesis)
Palace Map (Synthesis)|Map:Palace Map (Synthesis)
Park Map (Synthesis)|Map:Park Map (Synthesis)
Pen Map (Synthesis)|Map:Pen Map (Synthesis)
Peninsula Map (Synthesis)|Map:Peninsula Map (Synthesis)
Phantasmagoria Map (Synthesis)|Map:Phantasmagoria Map (Synthesis)
Pier Map (Synthesis)|Map:Pier Map (Synthesis)
Pit Map (Synthesis)|Map:Pit Map (Synthesis)
Pit of the Chimera Map (Synthesis)|Map:Pit of the Chimera Map (Synthesis)
Plateau Map (Synthesis)|Map:Plateau Map (Synthesis)
Plaza Map (Synthesis)|Map:Plaza Map (Synthesis)
Port Map (Synthesis)|Map:Port Map (Synthesis)
Precinct Map (Synthesis)|Map:Precinct Map (Synthesis)
Primordial Blocks Map (Synthesis)|Map:Primordial Blocks Map (Synthesis)
Primordial Pool Map (Synthesis)|Map:Primordial Pool Map (Synthesis)
Promenade Map (Synthesis)|Map:Promenade Map (Synthesis)
Racecourse Map (Synthesis)|Map:Racecourse Map (Synthesis)
Ramparts Map (Synthesis)|Map:Ramparts Map (Synthesis)
Reef Map (Synthesis)|Map:Reef Map (Synthesis)
Relic Chambers Map (Synthesis)|Map:Relic Chambers Map (Synthesis)
Residence Map (Synthesis)|Map:Residence Map (Synthesis)
Scriptorium Map (Synthesis)|Map:Scriptorium Map (Synthesis)
Sepulchre Map (Synthesis)|Map:Sepulchre Map (Synthesis)
Shipyard Map (Synthesis)|Map:Shipyard Map (Synthesis)
Shore Map (Synthesis)|Map:Shore Map (Synthesis)
Shrine Map (Synthesis)|Map:Shrine Map (Synthesis)
Siege Map (Synthesis)|Map:Siege Map (Synthesis)
Spider Forest Map (Synthesis)|Map:Spider Forest Map (Synthesis)
Spider Lair Map (Synthesis)|Map:Spider Lair Map (Synthesis)
Strand Map (Synthesis)|Map:Strand Map (Synthesis)
Sulphur Vents Map (Synthesis)|Map:Sulphur Vents Map (Synthesis)
Summit Map (Synthesis)|Map:Summit Map (Synthesis)
Sunken City Map (Synthesis)|Map:Sunken City Map (Synthesis)
Temple Map (Synthesis)|Map:Temple Map (Synthesis)
Terrace Map (Synthesis)|Map:Terrace Map (Synthesis)
The Coward's Trial (Synthesis)|Map:The Coward's Trial (Synthesis)
Thicket Map (Synthesis)|Map:Thicket Map (Synthesis)
Tower Map (Synthesis)|Map:Tower Map (Synthesis)
Toxic Sewer Map (Synthesis)|Map:Toxic Sewer Map (Synthesis)
Tropical Island Map (Synthesis)|Map:Tropical Island Map (Synthesis)
Underground River Map (Synthesis)|Map:Underground River Map (Synthesis)
Underground Sea Map (Synthesis)|Map:Underground Sea Map (Synthesis)
Vaal Pyramid Map (Synthesis)|Map:Vaal Pyramid Map (Synthesis)
Vaal Temple Map (Synthesis)|Map:Vaal Temple Map (Synthesis)
Vault Map (Synthesis)|Map:Vault Map (Synthesis)
Villa Map (Synthesis)|Map:Villa Map (Synthesis)
Volcano Map (Synthesis)|Map:Volcano Map (Synthesis)
Waste Pool Map (Synthesis)|Map:Waste Pool Map (Synthesis)
Wasteland Map (Synthesis)|Map:Wasteland Map (Synthesis)
Waterways Map (Synthesis)|Map:Waterways Map (Synthesis)
Wharf Map (Synthesis)|Map:Wharf Map (Synthesis)
Academy Map (Legion)|Map:Academy Map (Legion)
Acid Caverns Map (Legion)|Map:Acid Caverns Map (Legion)
Alleyways Map (Legion)|Map:Alleyways Map (Legion)
Ancient City Map (Legion)|Map:Ancient City Map (Legion)
Arachnid Nest Map (Legion)|Map:Arachnid Nest Map (Legion)
Arachnid Tomb Map (Legion)|Map:Arachnid Tomb Map (Legion)
Arcade Map (Legion)|Map:Arcade Map (Legion)
Arena Map (Legion)|Map:Arena Map (Legion)
Arid Lake Map (Legion)|Map:Arid Lake Map (Legion)
Armoury Map (Legion)|Map:Armoury Map (Legion)
Arsenal Map (Legion)|Map:Arsenal Map (Legion)
Ashen Wood Map (Legion)|Map:Ashen Wood Map (Legion)
Atoll Map (Legion)|Map:Atoll Map (Legion)
Barrows Map (Legion)|Map:Barrows Map (Legion)
Basilica Map (Legion)|Map:Basilica Map (Legion)
Bazaar Map (Legion)|Map:Bazaar Map (Legion)
Beach Map (Legion)|Map:Beach Map (Legion)
Belfry Map (Legion)|Map:Belfry Map (Legion)
Bog Map (Legion)|Map:Bog Map (Legion)
Bone Crypt Map (Legion)|Map:Bone Crypt Map (Legion)
Burial Chambers Map (Legion)|Map:Burial Chambers Map (Legion)
Cage Map (Legion)|Map:Cage Map (Legion)
Caldera Map (Legion)|Map:Caldera Map (Legion)
Canyon Map (Legion)|Map:Canyon Map (Legion)
Carcass Map (Legion)|Map:Carcass Map (Legion)
Castle Ruins Map (Legion)|Map:Castle Ruins Map (Legion)
Cells Map (Legion)|Map:Cells Map (Legion)
Cemetery Map (Legion)|Map:Cemetery Map (Legion)
Channel Map (Legion)|Map:Channel Map (Legion)
Chateau Map (Legion)|Map:Chateau Map (Legion)
City Square Map (Legion)|Map:City Square Map (Legion)
Colonnade Map (Legion)|Map:Colonnade Map (Legion)
Colosseum Map (Legion)|Map:Colosseum Map (Legion)
Conservatory Map (Legion)|Map:Conservatory Map (Legion)
Coral Ruins Map (Legion)|Map:Coral Ruins Map (Legion)
Core Map (Legion)|Map:Core Map (Legion)
Courthouse Map (Legion)|Map:Courthouse Map (Legion)
Courtyard Map (Legion)|Map:Courtyard Map (Legion)
Coves Map (Legion)|Map:Coves Map (Legion)
Crater Map (Legion)|Map:Crater Map (Legion)
Crimson Temple Map (Legion)|Map:Crimson Temple Map (Legion)
Crystal Ore Map (Legion)|Map:Crystal Ore Map (Legion)
Cursed Crypt Map (Legion)|Map:Cursed Crypt Map (Legion)
Dark Forest Map (Legion)|Map:Dark Forest Map (Legion)
Defiled Cathedral Map (Legion)|Map:Defiled Cathedral Map (Legion)
Desert Map (Legion)|Map:Desert Map (Legion)
Desert Spring Map (Legion)|Map:Desert Spring Map (Legion)
Dig Map (Legion)|Map:Dig Map (Legion)
Dunes Map (Legion)|Map:Dunes Map (Legion)
Dungeon Map (Legion)|Map:Dungeon Map (Legion)
Estuary Map (Legion)|Map:Estuary Map (Legion)
Excavation Map (Legion)|Map:Excavation Map (Legion)
Factory Map (Legion)|Map:Factory Map (Legion)
Fields Map (Legion)|Map:Fields Map (Legion)
Flooded Mine Map (Legion)|Map:Flooded Mine Map (Legion)
Forge of the Phoenix Map (Legion)|Map:Forge of the Phoenix Map (Legion)
Fungal Hollow Map (Legion)|Map:Fungal Hollow Map (Legion)
Gardens Map (Legion)|Map:Gardens Map (Legion)
Geode Map (Legion)|Map:Geode Map (Legion)
Ghetto Map (Legion)|Map:Ghetto Map (Legion)
Glacier Map (Legion)|Map:Glacier Map (Legion)
Graveyard Map (Legion)|Map:Graveyard Map (Legion)
Grotto Map (Legion)|Map:Grotto Map (Legion)
Harbinger Map (Low Tier) (Legion)|Map:Harbinger Map (Low Tier) (Legion)
Haunted Mansion Map (Legion)|Map:Haunted Mansion Map (Legion)
Iceberg Map (Legion)|Map:Iceberg Map (Legion)
Infested Valley Map (Legion)|Map:Infested Valley Map (Legion)
Ivory Temple Map (Legion)|Map:Ivory Temple Map (Legion)
Jungle Valley Map (Legion)|Map:Jungle Valley Map (Legion)
Laboratory Map (Legion)|Map:Laboratory Map (Legion)
Lair Map (Legion)|Map:Lair Map (Legion)
Lair of the Hydra Map (Legion)|Map:Lair of the Hydra Map (Legion)
Lava Chamber Map (Legion)|Map:Lava Chamber Map (Legion)
Lava Lake Map (Legion)|Map:Lava Lake Map (Legion)
Leyline Map (Legion)|Map:Leyline Map (Legion)
Lighthouse Map (Legion)|Map:Lighthouse Map (Legion)
Lookout Map (Legion)|Map:Lookout Map (Legion)
Malformation Map (Legion)|Map:Malformation Map (Legion)
Marshes Map (Legion)|Map:Marshes Map (Legion)
Mausoleum Map (Legion)|Map:Mausoleum Map (Legion)
Maze Map (Legion)|Map:Maze Map (Legion)
Maze of the Minotaur Map (Legion)|Map:Maze of the Minotaur Map (Legion)
Mesa Map (Legion)|Map:Mesa Map (Legion)
Mineral Pools Map (Legion)|Map:Mineral Pools Map (Legion)
Moon Temple Map (Legion)|Map:Moon Temple Map (Legion)
Mud Geyser Map (Legion)|Map:Mud Geyser Map (Legion)
Museum Map (Legion)|Map:Museum Map (Legion)
Necropolis Map (Legion)|Map:Necropolis Map (Legion)
Orchard Map (Legion)|Map:Orchard Map (Legion)
Overgrown Ruin Map (Legion)|Map:Overgrown Ruin Map (Legion)
Overgrown Shrine Map (Legion)|Map:Overgrown Shrine Map (Legion)
Palace Map (Legion)|Map:Palace Map (Legion)
Park Map (Legion)|Map:Park Map (Legion)
Pen Map (Legion)|Map:Pen Map (Legion)
Peninsula Map (Legion)|Map:Peninsula Map (Legion)
Phantasmagoria Map (Legion)|Map:Phantasmagoria Map (Legion)
Pier Map (Legion)|Map:Pier Map (Legion)
Pit Map (Legion)|Map:Pit Map (Legion)
Pit of the Chimera Map (Legion)|Map:Pit of the Chimera Map (Legion)
Plateau Map (Legion)|Map:Plateau Map (Legion)
Plaza Map (Legion)|Map:Plaza Map (Legion)
Port Map (Legion)|Map:Port Map (Legion)
Precinct Map (Legion)|Map:Precinct Map (Legion)
Primordial Blocks Map (Legion)|Map:Primordial Blocks Map (Legion)
Primordial Pool Map (Legion)|Map:Primordial Pool Map (Legion)
Promenade Map (Legion)|Map:Promenade Map (Legion)
Racecourse Map (Legion)|Map:Racecourse Map (Legion)
Ramparts Map (Legion)|Map:Ramparts Map (Legion)
Reef Map (Legion)|Map:Reef Map (Legion)
Relic Chambers Map (Legion)|Map:Relic Chambers Map (Legion)
Residence Map (Legion)|Map:Residence Map (Legion)
Scriptorium Map (Legion)|Map:Scriptorium Map (Legion)
Sepulchre Map (Legion)|Map:Sepulchre Map (Legion)
Shipyard Map (Legion)|Map:Shipyard Map (Legion)
Shore Map (Legion)|Map:Shore Map (Legion)
Shrine Map (Legion)|Map:Shrine Map (Legion)
Siege Map (Legion)|Map:Siege Map (Legion)
Spider Forest Map (Legion)|Map:Spider Forest Map (Legion)
Spider Lair Map (Legion)|Map:Spider Lair Map (Legion)
Strand Map (Legion)|Map:Strand Map (Legion)
Sulphur Vents Map (Legion)|Map:Sulphur Vents Map (Legion)
Summit Map (Legion)|Map:Summit Map (Legion)
Sunken City Map (Legion)|Map:Sunken City Map (Legion)
Temple Map (Legion)|Map:Temple Map (Legion)
Terrace Map (Legion)|Map:Terrace Map (Legion)
The Coward's Trial (Legion)|Map:The Coward's Trial (Legion)
Thicket Map (Legion)|Map:Thicket Map (Legion)
Tower Map (Legion)|Map:Tower Map (Legion)
Toxic Sewer Map (Legion)|Map:Toxic Sewer Map (Legion)
Tropical Island Map (Legion)|Map:Tropical Island Map (Legion)
Underground River Map (Legion)|Map:Underground River Map (Legion)
Underground Sea Map (Legion)|Map:Underground Sea Map (Legion)
Vaal Pyramid Map (Legion)|Map:Vaal Pyramid Map (Legion)
Vaal Temple Map (Legion)|Map:Vaal Temple Map (Legion)
Vault Map (Legion)|Map:Vault Map (Legion)
Villa Map (Legion)|Map:Villa Map (Legion)
Volcano Map (Legion)|Map:Volcano Map (Legion)
Waste Pool Map (Legion)|Map:Waste Pool Map (Legion)
Wasteland Map (Legion)|Map:Wasteland Map (Legion)
Waterways Map (Legion)|Map:Waterways Map (Legion)
Wharf Map (Legion)|Map:Wharf Map (Legion)
Academy Map (Blight)|Map:Academy Map (Blight)
Acid Caverns Map (Blight)|Map:Acid Caverns Map (Blight)
Alleyways Map (Blight)|Map:Alleyways Map (Blight)
Ancient City Map (Blight)|Map:Ancient City Map (Blight)
Arachnid Nest Map (Blight)|Map:Arachnid Nest Map (Blight)
Arachnid Tomb Map (Blight)|Map:Arachnid Tomb Map (Blight)
Arcade Map (Blight)|Map:Arcade Map (Blight)
Arena Map (Blight)|Map:Arena Map (Blight)
Arid Lake Map (Blight)|Map:Arid Lake Map (Blight)
Armoury Map (Blight)|Map:Armoury Map (Blight)
Arsenal Map (Blight)|Map:Arsenal Map (Blight)
Ashen Wood Map (Blight)|Map:Ashen Wood Map (Blight)
Atoll Map (Blight)|Map:Atoll Map (Blight)
Barrows Map (Blight)|Map:Barrows Map (Blight)
Basilica Map (Blight)|Map:Basilica Map (Blight)
Bazaar Map (Blight)|Map:Bazaar Map (Blight)
Beach Map (Blight)|Map:Beach Map (Blight)
Belfry Map (Blight)|Map:Belfry Map (Blight)
Bog Map (Blight)|Map:Bog Map (Blight)
Bone Crypt Map (Blight)|Map:Bone Crypt Map (Blight)
Burial Chambers Map (Blight)|Map:Burial Chambers Map (Blight)
Cage Map (Blight)|Map:Cage Map (Blight)
Caldera Map (Blight)|Map:Caldera Map (Blight)
Canyon Map (Blight)|Map:Canyon Map (Blight)
Carcass Map (Blight)|Map:Carcass Map (Blight)
Castle Ruins Map (Blight)|Map:Castle Ruins Map (Blight)
Cells Map (Blight)|Map:Cells Map (Blight)
Cemetery Map (Blight)|Map:Cemetery Map (Blight)
Channel Map (Blight)|Map:Channel Map (Blight)
Chateau Map (Blight)|Map:Chateau Map (Blight)
City Square Map (Blight)|Map:City Square Map (Blight)
Colonnade Map (Blight)|Map:Colonnade Map (Blight)
Colosseum Map (Blight)|Map:Colosseum Map (Blight)
Conservatory Map (Blight)|Map:Conservatory Map (Blight)
Coral Ruins Map (Blight)|Map:Coral Ruins Map (Blight)
Core Map (Blight)|Map:Core Map (Blight)
Courthouse Map (Blight)|Map:Courthouse Map (Blight)
Courtyard Map (Blight)|Map:Courtyard Map (Blight)
Coves Map (Blight)|Map:Coves Map (Blight)
Crater Map (Blight)|Map:Crater Map (Blight)
Crimson Temple Map (Blight)|Map:Crimson Temple Map (Blight)
Crystal Ore Map (Blight)|Map:Crystal Ore Map (Blight)
Cursed Crypt Map (Blight)|Map:Cursed Crypt Map (Blight)
Dark Forest Map (Blight)|Map:Dark Forest Map (Blight)
Defiled Cathedral Map (Blight)|Map:Defiled Cathedral Map (Blight)
Desert Map (Blight)|Map:Desert Map (Blight)
Desert Spring Map (Blight)|Map:Desert Spring Map (Blight)
Dig Map (Blight)|Map:Dig Map (Blight)
Dunes Map (Blight)|Map:Dunes Map (Blight)
Dungeon Map (Blight)|Map:Dungeon Map (Blight)
Estuary Map (Blight)|Map:Estuary Map (Blight)
Excavation Map (Blight)|Map:Excavation Map (Blight)
Factory Map (Blight)|Map:Factory Map (Blight)
Fields Map (Blight)|Map:Fields Map (Blight)
Flooded Mine Map (Blight)|Map:Flooded Mine Map (Blight)
Forge of the Phoenix Map (Blight)|Map:Forge of the Phoenix Map (Blight)
Fungal Hollow Map (Blight)|Map:Fungal Hollow Map (Blight)
Gardens Map (Blight)|Map:Gardens Map (Blight)
Geode Map (Blight)|Map:Geode Map (Blight)
Ghetto Map (Blight)|Map:Ghetto Map (Blight)
Glacier Map (Blight)|Map:Glacier Map (Blight)
Graveyard Map (Blight)|Map:Graveyard Map (Blight)
Grotto Map (Blight)|Map:Grotto Map (Blight)
Harbinger Map (Low Tier) (Blight)|Map:Harbinger Map (Low Tier) (Blight)
Haunted Mansion Map (Blight)|Map:Haunted Mansion Map (Blight)
Iceberg Map (Blight)|Map:Iceberg Map (Blight)
Infested Valley Map (Blight)|Map:Infested Valley Map (Blight)
Ivory Temple Map (Blight)|Map:Ivory Temple Map (Blight)
Jungle Valley Map (Blight)|Map:Jungle Valley Map (Blight)
Laboratory Map (Blight)|Map:Laboratory Map (Blight)
Lair Map (Blight)|Map:Lair Map (Blight)
Lair of the Hydra Map (Blight)|Map:Lair of the Hydra Map (Blight)
Lava Chamber Map (Blight)|Map:Lava Chamber Map (Blight)
Lava Lake Map (Blight)|Map:Lava Lake Map (Blight)
Leyline Map (Blight)|Map:Leyline Map (Blight)
Lighthouse Map (Blight)|Map:Lighthouse Map (Blight)
Lookout Map (Blight)|Map:Lookout Map (Blight)
Malformation Map (Blight)|Map:Malformation Map (Blight)
Marshes Map (Blight)|Map:Marshes Map (Blight)
Mausoleum Map (Blight)|Map:Mausoleum Map (Blight)
Maze Map (Blight)|Map:Maze Map (Blight)
Maze of the Minotaur Map (Blight)|Map:Maze of the Minotaur Map (Blight)
Mesa Map (Blight)|Map:Mesa Map (Blight)
Mineral Pools Map (Blight)|Map:Mineral Pools Map (Blight)
Moon Temple Map (Blight)|Map:Moon Temple Map (Blight)
Mud Geyser Map (Blight)|Map:Mud Geyser Map (Blight)
Museum Map (Blight)|Map:Museum Map (Blight)
Necropolis Map (Blight)|Map:Necropolis Map (Blight)
Orchard Map (Blight)|Map:Orchard Map (Blight)
Overgrown Ruin Map (Blight)|Map:Overgrown Ruin Map (Blight)
Overgrown Shrine Map (Blight)|Map:Overgrown Shrine Map (Blight)
Palace Map (Blight)|Map:Palace Map (Blight)
Park Map (Blight)|Map:Park Map (Blight)
Pen Map (Blight)|Map:Pen Map (Blight)
Peninsula Map (Blight)|Map:Peninsula Map (Blight)
Phantasmagoria Map (Blight)|Map:Phantasmagoria Map (Blight)
Pier Map (Blight)|Map:Pier Map (Blight)
Pit Map (Blight)|Map:Pit Map (Blight)
Pit of the Chimera Map (Blight)|Map:Pit of the Chimera Map (Blight)
Plateau Map (Blight)|Map:Plateau Map (Blight)
Plaza Map (Blight)|Map:Plaza Map (Blight)
Port Map (Blight)|Map:Port Map (Blight)
Precinct Map (Blight)|Map:Precinct Map (Blight)
Primordial Blocks Map (Blight)|Map:Primordial Blocks Map (Blight)
Primordial Pool Map (Blight)|Map:Primordial Pool Map (Blight)
Promenade Map (Blight)|Map:Promenade Map (Blight)
Racecourse Map (Blight)|Map:Racecourse Map (Blight)
Ramparts Map (Blight)|Map:Ramparts Map (Blight)
Reef Map (Blight)|Map:Reef Map (Blight)
Relic Chambers Map (Blight)|Map:Relic Chambers Map (Blight)
Residence Map (Blight)|Map:Residence Map (Blight)
Scriptorium Map (Blight)|Map:Scriptorium Map (Blight)
Sepulchre Map (Blight)|Map:Sepulchre Map (Blight)
Shipyard Map (Blight)|Map:Shipyard Map (Blight)
Shore Map (Blight)|Map:Shore Map (Blight)
Shrine Map (Blight)|Map:Shrine Map (Blight)
Siege Map (Blight)|Map:Siege Map (Blight)
Spider Forest Map (Blight)|Map:Spider Forest Map (Blight)
Spider Lair Map (Blight)|Map:Spider Lair Map (Blight)
Strand Map (Blight)|Map:Strand Map (Blight)
Sulphur Vents Map (Blight)|Map:Sulphur Vents Map (Blight)
Summit Map (Blight)|Map:Summit Map (Blight)
Sunken City Map (Blight)|Map:Sunken City Map (Blight)
Temple Map (Blight)|Map:Temple Map (Blight)
Terrace Map (Blight)|Map:Terrace Map (Blight)
The Coward's Trial (Blight)|Map:The Coward's Trial (Blight)
Thicket Map (Blight)|Map:Thicket Map (Blight)
Tower Map (Blight)|Map:Tower Map (Blight)
Toxic Sewer Map (Blight)|Map:Toxic Sewer Map (Blight)
Tropical Island Map (Blight)|Map:Tropical Island Map (Blight)
Underground River Map (Blight)|Map:Underground River Map (Blight)
Underground Sea Map (Blight)|Map:Underground Sea Map (Blight)
Vaal Pyramid Map (Blight)|Map:Vaal Pyramid Map (Blight)
Vaal Temple Map (Blight)|Map:Vaal Temple Map (Blight)
Vault Map (Blight)|Map:Vault Map (Blight)
Villa Map (Blight)|Map:Villa Map (Blight)
Volcano Map (Blight)|Map:Volcano Map (Blight)
Waste Pool Map (Blight)|Map:Waste Pool Map (Blight)
Wasteland Map (Blight)|Map:Wasteland Map (Blight)
Waterways Map (Blight)|Map:Waterways Map (Blight)
Wharf Map (Blight)|Map:Wharf Map (Blight)
Academy Map (Metamorph)|Map:Academy Map (Metamorph)
Acid Caverns Map (Metamorph)|Map:Acid Caverns Map (Metamorph)
Alleyways Map (Metamorph)|Map:Alleyways Map (Metamorph)
Ancient City Map (Metamorph)|Map:Ancient City Map (Metamorph)
Arachnid Nest Map (Metamorph)|Map:Arachnid Nest Map (Metamorph)
Arachnid Tomb Map (Metamorph)|Map:Arachnid Tomb Map (Metamorph)
Arcade Map (Metamorph)|Map:Arcade Map (Metamorph)
Arena Map (Metamorph)|Map:Arena Map (Metamorph)
Arid Lake Map (Metamorph)|Map:Arid Lake Map (Metamorph)
Armoury Map (Metamorph)|Map:Armoury Map (Metamorph)
Arsenal Map (Metamorph)|Map:Arsenal Map (Metamorph)
Ashen Wood Map (Metamorph)|Map:Ashen Wood Map (Metamorph)
Atoll Map (Metamorph)|Map:Atoll Map (Metamorph)
Barrows Map (Metamorph)|Map:Barrows Map (Metamorph)
Basilica Map (Metamorph)|Map:Basilica Map (Metamorph)
Bazaar Map (Metamorph)|Map:Bazaar Map (Metamorph)
Beach Map (Metamorph)|Map:Beach Map (Metamorph)
Belfry Map (Metamorph)|Map:Belfry Map (Metamorph)
Bog Map (Metamorph)|Map:Bog Map (Metamorph)
Bone Crypt Map (Metamorph)|Map:Bone Crypt Map (Metamorph)
Burial Chambers Map (Metamorph)|Map:Burial Chambers Map (Metamorph)
Cage Map (Metamorph)|Map:Cage Map (Metamorph)
Caldera Map (Metamorph)|Map:Caldera Map (Metamorph)
Canyon Map (Metamorph)|Map:Canyon Map (Metamorph)
Carcass Map (Metamorph)|Map:Carcass Map (Metamorph)
Castle Ruins Map (Metamorph)|Map:Castle Ruins Map (Metamorph)
Cells Map (Metamorph)|Map:Cells Map (Metamorph)
Cemetery Map (Metamorph)|Map:Cemetery Map (Metamorph)
Channel Map (Metamorph)|Map:Channel Map (Metamorph)
Chateau Map (Metamorph)|Map:Chateau Map (Metamorph)
City Square Map (Metamorph)|Map:City Square Map (Metamorph)
Colonnade Map (Metamorph)|Map:Colonnade Map (Metamorph)
Colosseum Map (Metamorph)|Map:Colosseum Map (Metamorph)
Conservatory Map (Metamorph)|Map:Conservatory Map (Metamorph)
Coral Ruins Map (Metamorph)|Map:Coral Ruins Map (Metamorph)
Core Map (Metamorph)|Map:Core Map (Metamorph)
Courthouse Map (Metamorph)|Map:Courthouse Map (Metamorph)
Courtyard Map (Metamorph)|Map:Courtyard Map (Metamorph)
Coves Map (Metamorph)|Map:Coves Map (Metamorph)
Crater Map (Metamorph)|Map:Crater Map (Metamorph)
Crimson Temple Map (Metamorph)|Map:Crimson Temple Map (Metamorph)
Crystal Ore Map (Metamorph)|Map:Crystal Ore Map (Metamorph)
Cursed Crypt Map (Metamorph)|Map:Cursed Crypt Map (Metamorph)
Dark Forest Map (Metamorph)|Map:Dark Forest Map (Metamorph)
Defiled Cathedral Map (Metamorph)|Map:Defiled Cathedral Map (Metamorph)
Desert Map (Metamorph)|Map:Desert Map (Metamorph)
Desert Spring Map (Metamorph)|Map:Desert Spring Map (Metamorph)
Dig Map (Metamorph)|Map:Dig Map (Metamorph)
Dunes Map (Metamorph)|Map:Dunes Map (Metamorph)
Dungeon Map (Metamorph)|Map:Dungeon Map (Metamorph)
Estuary Map (Metamorph)|Map:Estuary Map (Metamorph)
Excavation Map (Metamorph)|Map:Excavation Map (Metamorph)
Factory Map (Metamorph)|Map:Factory Map (Metamorph)
Fields Map (Metamorph)|Map:Fields Map (Metamorph)
Flooded Mine Map (Metamorph)|Map:Flooded Mine Map (Metamorph)
Fungal Hollow Map (Metamorph)|Map:Fungal Hollow Map (Metamorph)
Gardens Map (Metamorph)|Map:Gardens Map (Metamorph)
Geode Map (Metamorph)|Map:Geode Map (Metamorph)
Ghetto Map (Metamorph)|Map:Ghetto Map (Metamorph)
Glacier Map (Metamorph)|Map:Glacier Map (Metamorph)
Graveyard Map (Metamorph)|Map:Graveyard Map (Metamorph)
Grotto Map (Metamorph)|Map:Grotto Map (Metamorph)
Harbinger Map (Low Tier) (Metamorph)|Map:Harbinger Map (Low Tier) (Metamorph)
Haunted Mansion Map (Metamorph)|Map:Haunted Mansion Map (Metamorph)
Iceberg Map (Metamorph)|Map:Iceberg Map (Metamorph)
Infested Valley Map (Metamorph)|Map:Infested Valley Map (Metamorph)
Ivory Temple Map (Metamorph)|Map:Ivory Temple Map (Metamorph)
Jungle Valley Map (Metamorph)|Map:Jungle Valley Map (Metamorph)
Laboratory Map (Metamorph)|Map:Laboratory Map (Metamorph)
Lair Map (Metamorph)|Map:Lair Map (Metamorph)
Lava Chamber Map (Metamorph)|Map:Lava Chamber Map (Metamorph)
Lava Lake Map (Metamorph)|Map:Lava Lake Map (Metamorph)
Leyline Map (Metamorph)|Map:Leyline Map (Metamorph)
Lighthouse Map (Metamorph)|Map:Lighthouse Map (Metamorph)
Lookout Map (Metamorph)|Map:Lookout Map (Metamorph)
Malformation Map (Metamorph)|Map:Malformation Map (Metamorph)
Marshes Map (Metamorph)|Map:Marshes Map (Metamorph)
Mausoleum Map (Metamorph)|Map:Mausoleum Map (Metamorph)
Maze Map (Metamorph)|Map:Maze Map (Metamorph)
Mesa Map (Metamorph)|Map:Mesa Map (Metamorph)
Mineral Pools Map (Metamorph)|Map:Mineral Pools Map (Metamorph)
Moon Temple Map (Metamorph)|Map:Moon Temple Map (Metamorph)
Mud Geyser Map (Metamorph)|Map:Mud Geyser Map (Metamorph)
Museum Map (Metamorph)|Map:Museum Map (Metamorph)
Necropolis Map (Metamorph)|Map:Necropolis Map (Metamorph)
Orchard Map (Metamorph)|Map:Orchard Map (Metamorph)
Overgrown Ruin Map (Metamorph)|Map:Overgrown Ruin Map (Metamorph)
Overgrown Shrine Map (Metamorph)|Map:Overgrown Shrine Map (Metamorph)
Palace Map (Metamorph)|Map:Palace Map (Metamorph)
Park Map (Metamorph)|Map:Park Map (Metamorph)
Pen Map (Metamorph)|Map:Pen Map (Metamorph)
Peninsula Map (Metamorph)|Map:Peninsula Map (Metamorph)
Phantasmagoria Map (Metamorph)|Map:Phantasmagoria Map (Metamorph)
Pier Map (Metamorph)|Map:Pier Map (Metamorph)
Pit Map (Metamorph)|Map:Pit Map (Metamorph)
Plateau Map (Metamorph)|Map:Plateau Map (Metamorph)
Plaza Map (Metamorph)|Map:Plaza Map (Metamorph)
Port Map (Metamorph)|Map:Port Map (Metamorph)
Precinct Map (Metamorph)|Map:Precinct Map (Metamorph)
Primordial Blocks Map (Metamorph)|Map:Primordial Blocks Map (Metamorph)
Primordial Pool Map (Metamorph)|Map:Primordial Pool Map (Metamorph)
Promenade Map (Metamorph)|Map:Promenade Map (Metamorph)
Racecourse Map (Metamorph)|Map:Racecourse Map (Metamorph)
Ramparts Map (Metamorph)|Map:Ramparts Map (Metamorph)
Reef Map (Metamorph)|Map:Reef Map (Metamorph)
Relic Chambers Map (Metamorph)|Map:Relic Chambers Map (Metamorph)
Residence Map (Metamorph)|Map:Residence Map (Metamorph)
Scriptorium Map (Metamorph)|Map:Scriptorium Map (Metamorph)
Sepulchre Map (Metamorph)|Map:Sepulchre Map (Metamorph)
Shipyard Map (Metamorph)|Map:Shipyard Map (Metamorph)
Shore Map (Metamorph)|Map:Shore Map (Metamorph)
Shrine Map (Metamorph)|Map:Shrine Map (Metamorph)
Siege Map (Metamorph)|Map:Siege Map (Metamorph)
Spider Forest Map (Metamorph)|Map:Spider Forest Map (Metamorph)
Spider Lair Map (Metamorph)|Map:Spider Lair Map (Metamorph)
Strand Map (Metamorph)|Map:Strand Map (Metamorph)
Sulphur Vents Map (Metamorph)|Map:Sulphur Vents Map (Metamorph)
Summit Map (Metamorph)|Map:Summit Map (Metamorph)
Sunken City Map (Metamorph)|Map:Sunken City Map (Metamorph)
Temple Map (Metamorph)|Map:Temple Map (Metamorph)
Terrace Map (Metamorph)|Map:Terrace Map (Metamorph)
The Coward's Trial (Metamorph)|Map:The Coward's Trial (Metamorph)
Thicket Map (Metamorph)|Map:Thicket Map (Metamorph)
Tower Map (Metamorph)|Map:Tower Map (Metamorph)
Toxic Sewer Map (Metamorph)|Map:Toxic Sewer Map (Metamorph)
Tropical Island Map (Metamorph)|Map:Tropical Island Map (Metamorph)
Underground River Map (Metamorph)|Map:Underground River Map (Metamorph)
Underground Sea Map (Metamorph)|Map:Underground Sea Map (Metamorph)
Vaal Pyramid Map (Metamorph)|Map:Vaal Pyramid Map (Metamorph)
Vaal Temple Map (Metamorph)|Map:Vaal Temple Map (Metamorph)
Vault Map (Metamorph)|Map:Vault Map (Metamorph)
Villa Map (Metamorph)|Map:Villa Map (Metamorph)
Volcano Map (Metamorph)|Map:Volcano Map (Metamorph)
Waste Pool Map (Metamorph)|Map:Waste Pool Map (Metamorph)
Wasteland Map (Metamorph)|Map:Wasteland Map (Metamorph)
Waterways Map (Metamorph)|Map:Waterways Map (Metamorph)
Wharf Map (Metamorph)|Map:Wharf Map (Metamorph)
Academy Map (Delirium)|Map:Academy Map (Delirium)
Acid Caverns Map (Delirium)|Map:Acid Caverns Map (Delirium)
Alleyways Map (Delirium)|Map:Alleyways Map (Delirium)
Ancient City Map (Delirium)|Map:Ancient City Map (Delirium)
Arachnid Nest Map (Delirium)|Map:Arachnid Nest Map (Delirium)
Arachnid Tomb Map (Delirium)|Map:Arachnid Tomb Map (Delirium)
Arcade Map (Delirium)|Map:Arcade Map (Delirium)
Arena Map (Delirium)|Map:Arena Map (Delirium)
Arid Lake Map (Delirium)|Map:Arid Lake Map (Delirium)
Armoury Map (Delirium)|Map:Armoury Map (Delirium)
Arsenal Map (Delirium)|Map:Arsenal Map (Delirium)
Ashen Wood Map (Delirium)|Map:Ashen Wood Map (Delirium)
Atoll Map (Delirium)|Map:Atoll Map (Delirium)
Barrows Map (Delirium)|Map:Barrows Map (Delirium)
Basilica Map (Delirium)|Map:Basilica Map (Delirium)
Bazaar Map (Delirium)|Map:Bazaar Map (Delirium)
Beach Map (Delirium)|Map:Beach Map (Delirium)
Belfry Map (Delirium)|Map:Belfry Map (Delirium)
Bog Map (Delirium)|Map:Bog Map (Delirium)
Bone Crypt Map (Delirium)|Map:Bone Crypt Map (Delirium)
Burial Chambers Map (Delirium)|Map:Burial Chambers Map (Delirium)
Cage Map (Delirium)|Map:Cage Map (Delirium)
Caldera Map (Delirium)|Map:Caldera Map (Delirium)
Canyon Map (Delirium)|Map:Canyon Map (Delirium)
Carcass Map (Delirium)|Map:Carcass Map (Delirium)
Castle Ruins Map (Delirium)|Map:Castle Ruins Map (Delirium)
Cells Map (Delirium)|Map:Cells Map (Delirium)
Cemetery Map (Delirium)|Map:Cemetery Map (Delirium)
Channel Map (Delirium)|Map:Channel Map (Delirium)
Chateau Map (Delirium)|Map:Chateau Map (Delirium)
City Square Map (Delirium)|Map:City Square Map (Delirium)
Colonnade Map (Delirium)|Map:Colonnade Map (Delirium)
Colosseum Map (Delirium)|Map:Colosseum Map (Delirium)
Conservatory Map (Delirium)|Map:Conservatory Map (Delirium)
Coral Ruins Map (Delirium)|Map:Coral Ruins Map (Delirium)
Core Map (Delirium)|Map:Core Map (Delirium)
Courthouse Map (Delirium)|Map:Courthouse Map (Delirium)
Courtyard Map (Delirium)|Map:Courtyard Map (Delirium)
Coves Map (Delirium)|Map:Coves Map (Delirium)
Crater Map (Delirium)|Map:Crater Map (Delirium)
Crimson Temple Map (Delirium)|Map:Crimson Temple Map (Delirium)
Crystal Ore Map (Delirium)|Map:Crystal Ore Map (Delirium)
Cursed Crypt Map (Delirium)|Map:Cursed Crypt Map (Delirium)
Dark Forest Map (Delirium)|Map:Dark Forest Map (Delirium)
Defiled Cathedral Map (Delirium)|Map:Defiled Cathedral Map (Delirium)
Desert Map (Delirium)|Map:Desert Map (Delirium)
Desert Spring Map (Delirium)|Map:Desert Spring Map (Delirium)
Dig Map (Delirium)|Map:Dig Map (Delirium)
Dunes Map (Delirium)|Map:Dunes Map (Delirium)
Dungeon Map (Delirium)|Map:Dungeon Map (Delirium)
Estuary Map (Delirium)|Map:Estuary Map (Delirium)
Excavation Map (Delirium)|Map:Excavation Map (Delirium)
Factory Map (Delirium)|Map:Factory Map (Delirium)
Fields Map (Delirium)|Map:Fields Map (Delirium)
Flooded Mine Map (Delirium)|Map:Flooded Mine Map (Delirium)
Forge of the Phoenix Map (Delirium)|Map:Forge of the Phoenix Map (Delirium)
Fungal Hollow Map (Delirium)|Map:Fungal Hollow Map (Delirium)
Gardens Map (Delirium)|Map:Gardens Map (Delirium)
Geode Map (Delirium)|Map:Geode Map (Delirium)
Ghetto Map (Delirium)|Map:Ghetto Map (Delirium)
Glacier Map (Delirium)|Map:Glacier Map (Delirium)
Graveyard Map (Delirium)|Map:Graveyard Map (Delirium)
Grotto Map (Delirium)|Map:Grotto Map (Delirium)
Harbinger Map (High Tier) (Delirium)|Map:Harbinger Map (High Tier) (Delirium)
Harbinger Map (Low Tier) (Delirium)|Map:Harbinger Map (Low Tier) (Delirium)
Harbinger Map (Max Tier) (Delirium)|Map:Harbinger Map (Max Tier) (Delirium)
Harbinger Map (Mid Tier) (Delirium)|Map:Harbinger Map (Mid Tier) (Delirium)
Haunted Mansion Map (Delirium)|Map:Haunted Mansion Map (Delirium)
Iceberg Map (Delirium)|Map:Iceberg Map (Delirium)
Infested Valley Map (Delirium)|Map:Infested Valley Map (Delirium)
Ivory Temple Map (Delirium)|Map:Ivory Temple Map (Delirium)
Jungle Valley Map (Delirium)|Map:Jungle Valley Map (Delirium)
Laboratory Map (Delirium)|Map:Laboratory Map (Delirium)
Lair Map (Delirium)|Map:Lair Map (Delirium)
Lair of the Hydra Map (Delirium)|Map:Lair of the Hydra Map (Delirium)
Lava Chamber Map (Delirium)|Map:Lava Chamber Map (Delirium)
Lava Lake Map (Delirium)|Map:Lava Lake Map (Delirium)
Leyline Map (Delirium)|Map:Leyline Map (Delirium)
Lighthouse Map (Delirium)|Map:Lighthouse Map (Delirium)
Lookout Map (Delirium)|Map:Lookout Map (Delirium)
Malformation Map (Delirium)|Map:Malformation Map (Delirium)
Marshes Map (Delirium)|Map:Marshes Map (Delirium)
Mausoleum Map (Delirium)|Map:Mausoleum Map (Delirium)
Maze Map (Delirium)|Map:Maze Map (Delirium)
Maze of the Minotaur Map (Delirium)|Map:Maze of the Minotaur Map (Delirium)
Mesa Map (Delirium)|Map:Mesa Map (Delirium)
Mineral Pools Map (Delirium)|Map:Mineral Pools Map (Delirium)
Moon Temple Map (Delirium)|Map:Moon Temple Map (Delirium)
Mud Geyser Map (Delirium)|Map:Mud Geyser Map (Delirium)
Museum Map (Delirium)|Map:Museum Map (Delirium)
Necropolis Map (Delirium)|Map:Necropolis Map (Delirium)
Orchard Map (Delirium)|Map:Orchard Map (Delirium)
Overgrown Ruin Map (Delirium)|Map:Overgrown Ruin Map (Delirium)
Overgrown Shrine Map (Delirium)|Map:Overgrown Shrine Map (Delirium)
Palace Map (Delirium)|Map:Palace Map (Delirium)
Park Map (Delirium)|Map:Park Map (Delirium)
Pen Map (Delirium)|Map:Pen Map (Delirium)
Peninsula Map (Delirium)|Map:Peninsula Map (Delirium)
Phantasmagoria Map (Delirium)|Map:Phantasmagoria Map (Delirium)
Pier Map (Delirium)|Map:Pier Map (Delirium)
Pit Map (Delirium)|Map:Pit Map (Delirium)
Pit of the Chimera Map (Delirium)|Map:Pit of the Chimera Map (Delirium)
Plateau Map (Delirium)|Map:Plateau Map (Delirium)
Plaza Map (Delirium)|Map:Plaza Map (Delirium)
Port Map (Delirium)|Map:Port Map (Delirium)
Precinct Map (Delirium)|Map:Precinct Map (Delirium)
Primordial Blocks Map (Delirium)|Map:Primordial Blocks Map (Delirium)
Primordial Pool Map (Delirium)|Map:Primordial Pool Map (Delirium)
Promenade Map (Delirium)|Map:Promenade Map (Delirium)
Racecourse Map (Delirium)|Map:Racecourse Map (Delirium)
Ramparts Map (Delirium)|Map:Ramparts Map (Delirium)
Reef Map (Delirium)|Map:Reef Map (Delirium)
Relic Chambers Map (Delirium)|Map:Relic Chambers Map (Delirium)
Residence Map (Delirium)|Map:Residence Map (Delirium)
Scriptorium Map (Delirium)|Map:Scriptorium Map (Delirium)
Sepulchre Map (Delirium)|Map:Sepulchre Map (Delirium)
Shipyard Map (Delirium)|Map:Shipyard Map (Delirium)
Shore Map (Delirium)|Map:Shore Map (Delirium)
Shrine Map (Delirium)|Map:Shrine Map (Delirium)
Siege Map (Delirium)|Map:Siege Map (Delirium)
Spider Forest Map (Delirium)|Map:Spider Forest Map (Delirium)
Spider Lair Map (Delirium)|Map:Spider Lair Map (Delirium)
Strand Map (Delirium)|Map:Strand Map (Delirium)
Sulphur Vents Map (Delirium)|Map:Sulphur Vents Map (Delirium)
Summit Map (Delirium)|Map:Summit Map (Delirium)
Sunken City Map (Delirium)|Map:Sunken City Map (Delirium)
Temple Map (Delirium)|Map:Temple Map (Delirium)
Terrace Map (Delirium)|Map:Terrace Map (Delirium)
The Coward's Trial (Delirium)|Map:The Coward's Trial (Delirium)
The Shaper's Realm (Delirium)|Map:The Shaper's Realm (Delirium)
Thicket Map (Delirium)|Map:Thicket Map (Delirium)
Tower Map (Delirium)|Map:Tower Map (Delirium)
Toxic Sewer Map (Delirium)|Map:Toxic Sewer Map (Delirium)
Tropical Island Map (Delirium)|Map:Tropical Island Map (Delirium)
Underground River Map (Delirium)|Map:Underground River Map (Delirium)
Underground Sea Map (Delirium)|Map:Underground Sea Map (Delirium)
Vaal Pyramid Map (Delirium)|Map:Vaal Pyramid Map (Delirium)
Vaal Temple Map (Delirium)|Map:Vaal Temple Map (Delirium)
Vault Map (Delirium)|Map:Vault Map (Delirium)
Villa Map (Delirium)|Map:Villa Map (Delirium)
Volcano Map (Delirium)|Map:Volcano Map (Delirium)
Waste Pool Map (Delirium)|Map:Waste Pool Map (Delirium)
Wasteland Map (Delirium)|Map:Wasteland Map (Delirium)
Waterways Map (Delirium)|Map:Waterways Map (Delirium)
Wharf Map (Delirium)|Map:Wharf Map (Delirium)
Academy Map (Harvest)|Map:Academy Map (Harvest)
Acid Caverns Map (Harvest)|Map:Acid Caverns Map (Harvest)
Alleyways Map (Harvest)|Map:Alleyways Map (Harvest)
Ancient City Map (Harvest)|Map:Ancient City Map (Harvest)
Arachnid Nest Map (Harvest)|Map:Arachnid Nest Map (Harvest)
Arachnid Tomb Map (Harvest)|Map:Arachnid Tomb Map (Harvest)
Arcade Map (Harvest)|Map:Arcade Map (Harvest)
Arena Map (Harvest)|Map:Arena Map (Harvest)
Arid Lake Map (Harvest)|Map:Arid Lake Map (Harvest)
Armoury Map (Harvest)|Map:Armoury Map (Harvest)
Arsenal Map (Harvest)|Map:Arsenal Map (Harvest)
Ashen Wood Map (Harvest)|Map:Ashen Wood Map (Harvest)
Atoll Map (Harvest)|Map:Atoll Map (Harvest)
Barrows Map (Harvest)|Map:Barrows Map (Harvest)
Basilica Map (Harvest)|Map:Basilica Map (Harvest)
Bazaar Map (Harvest)|Map:Bazaar Map (Harvest)
Beach Map (Harvest)|Map:Beach Map (Harvest)
Belfry Map (Harvest)|Map:Belfry Map (Harvest)
Bog Map (Harvest)|Map:Bog Map (Harvest)
Bone Crypt Map (Harvest)|Map:Bone Crypt Map (Harvest)
Burial Chambers Map (Harvest)|Map:Burial Chambers Map (Harvest)
Cage Map (Harvest)|Map:Cage Map (Harvest)
Caldera Map (Harvest)|Map:Caldera Map (Harvest)
Canyon Map (Harvest)|Map:Canyon Map (Harvest)
Carcass Map (Harvest)|Map:Carcass Map (Harvest)
Castle Ruins Map (Harvest)|Map:Castle Ruins Map (Harvest)
Cells Map (Harvest)|Map:Cells Map (Harvest)
Cemetery Map (Harvest)|Map:Cemetery Map (Harvest)
Channel Map (Harvest)|Map:Channel Map (Harvest)
Chateau Map (Harvest)|Map:Chateau Map (Harvest)
City Square Map (Harvest)|Map:City Square Map (Harvest)
Colonnade Map (Harvest)|Map:Colonnade Map (Harvest)
Colosseum Map (Harvest)|Map:Colosseum Map (Harvest)
Conservatory Map (Harvest)|Map:Conservatory Map (Harvest)
Coral Ruins Map (Harvest)|Map:Coral Ruins Map (Harvest)
Core Map (Harvest)|Map:Core Map (Harvest)
Courthouse Map (Harvest)|Map:Courthouse Map (Harvest)
Courtyard Map (Harvest)|Map:Courtyard Map (Harvest)
Coves Map (Harvest)|Map:Coves Map (Harvest)
Crater Map (Harvest)|Map:Crater Map (Harvest)
Crimson Temple Map (Harvest)|Map:Crimson Temple Map (Harvest)
Crystal Ore Map (Harvest)|Map:Crystal Ore Map (Harvest)
Cursed Crypt Map (Harvest)|Map:Cursed Crypt Map (Harvest)
Dark Forest Map (Harvest)|Map:Dark Forest Map (Harvest)
Defiled Cathedral Map (Harvest)|Map:Defiled Cathedral Map (Harvest)
Desert Map (Harvest)|Map:Desert Map (Harvest)
Desert Spring Map (Harvest)|Map:Desert Spring Map (Harvest)
Dig Map (Harvest)|Map:Dig Map (Harvest)
Dunes Map (Harvest)|Map:Dunes Map (Harvest)
Dungeon Map (Harvest)|Map:Dungeon Map (Harvest)
Estuary Map (Harvest)|Map:Estuary Map (Harvest)
Excavation Map (Harvest)|Map:Excavation Map (Harvest)
Factory Map (Harvest)|Map:Factory Map (Harvest)
Fields Map (Harvest)|Map:Fields Map (Harvest)
Flooded Mine Map (Harvest)|Map:Flooded Mine Map (Harvest)
Forge of the Phoenix Map (Harvest)|Map:Forge of the Phoenix Map (Harvest)
Fungal Hollow Map (Harvest)|Map:Fungal Hollow Map (Harvest)
Gardens Map (Harvest)|Map:Gardens Map (Harvest)
Geode Map (Harvest)|Map:Geode Map (Harvest)
Ghetto Map (Harvest)|Map:Ghetto Map (Harvest)
Glacier Map (Harvest)|Map:Glacier Map (Harvest)
Graveyard Map (Harvest)|Map:Graveyard Map (Harvest)
Grotto Map (Harvest)|Map:Grotto Map (Harvest)
Harbinger Map (High Tier) (Harvest)|Map:Harbinger Map (High Tier) (Harvest)
Harbinger Map (Low Tier) (Harvest)|Map:Harbinger Map (Low Tier) (Harvest)
Harbinger Map (Max Tier) (Harvest)|Map:Harbinger Map (Max Tier) (Harvest)
Harbinger Map (Mid Tier) (Harvest)|Map:Harbinger Map (Mid Tier) (Harvest)
Haunted Mansion Map (Harvest)|Map:Haunted Mansion Map (Harvest)
Iceberg Map (Harvest)|Map:Iceberg Map (Harvest)
Infested Valley Map (Harvest)|Map:Infested Valley Map (Harvest)
Ivory Temple Map (Harvest)|Map:Ivory Temple Map (Harvest)
Jungle Valley Map (Harvest)|Map:Jungle Valley Map (Harvest)
Laboratory Map (Harvest)|Map:Laboratory Map (Harvest)
Lair Map (Harvest)|Map:Lair Map (Harvest)
Lair of the Hydra Map (Harvest)|Map:Lair of the Hydra Map (Harvest)
Lava Chamber Map (Harvest)|Map:Lava Chamber Map (Harvest)
Lava Lake Map (Harvest)|Map:Lava Lake Map (Harvest)
Leyline Map (Harvest)|Map:Leyline Map (Harvest)
Lighthouse Map (Harvest)|Map:Lighthouse Map (Harvest)
Lookout Map (Harvest)|Map:Lookout Map (Harvest)
Malformation Map (Harvest)|Map:Malformation Map (Harvest)
Marshes Map (Harvest)|Map:Marshes Map (Harvest)
Mausoleum Map (Harvest)|Map:Mausoleum Map (Harvest)
Maze Map (Harvest)|Map:Maze Map (Harvest)
Maze of the Minotaur Map (Harvest)|Map:Maze of the Minotaur Map (Harvest)
Mesa Map (Harvest)|Map:Mesa Map (Harvest)
Mineral Pools Map (Harvest)|Map:Mineral Pools Map (Harvest)
Moon Temple Map (Harvest)|Map:Moon Temple Map (Harvest)
Mud Geyser Map (Harvest)|Map:Mud Geyser Map (Harvest)
Museum Map (Harvest)|Map:Museum Map (Harvest)
Necropolis Map (Harvest)|Map:Necropolis Map (Harvest)
Orchard Map (Harvest)|Map:Orchard Map (Harvest)
Overgrown Ruin Map (Harvest)|Map:Overgrown Ruin Map (Harvest)
Overgrown Shrine Map (Harvest)|Map:Overgrown Shrine Map (Harvest)
Palace Map (Harvest)|Map:Palace Map (Harvest)
Park Map (Harvest)|Map:Park Map (Harvest)
Pen Map (Harvest)|Map:Pen Map (Harvest)
Peninsula Map (Harvest)|Map:Peninsula Map (Harvest)
Phantasmagoria Map (Harvest)|Map:Phantasmagoria Map (Harvest)
Pier Map (Harvest)|Map:Pier Map (Harvest)
Pit Map (Harvest)|Map:Pit Map (Harvest)
Pit of the Chimera Map (Harvest)|Map:Pit of the Chimera Map (Harvest)
Plateau Map (Harvest)|Map:Plateau Map (Harvest)
Plaza Map (Harvest)|Map:Plaza Map (Harvest)
Port Map (Harvest)|Map:Port Map (Harvest)
Precinct Map (Harvest)|Map:Precinct Map (Harvest)
Primordial Blocks Map (Harvest)|Map:Primordial Blocks Map (Harvest)
Primordial Pool Map (Harvest)|Map:Primordial Pool Map (Harvest)
Promenade Map (Harvest)|Map:Promenade Map (Harvest)
Racecourse Map (Harvest)|Map:Racecourse Map (Harvest)
Ramparts Map (Harvest)|Map:Ramparts Map (Harvest)
Reef Map (Harvest)|Map:Reef Map (Harvest)
Relic Chambers Map (Harvest)|Map:Relic Chambers Map (Harvest)
Residence Map (Harvest)|Map:Residence Map (Harvest)
Scriptorium Map (Harvest)|Map:Scriptorium Map (Harvest)
Sepulchre Map (Harvest)|Map:Sepulchre Map (Harvest)
Shipyard Map (Harvest)|Map:Shipyard Map (Harvest)
Shore Map (Harvest)|Map:Shore Map (Harvest)
Shrine Map (Harvest)|Map:Shrine Map (Harvest)
Siege Map (Harvest)|Map:Siege Map (Harvest)
Spider Forest Map (Harvest)|Map:Spider Forest Map (Harvest)
Spider Lair Map (Harvest)|Map:Spider Lair Map (Harvest)
Strand Map (Harvest)|Map:Strand Map (Harvest)
Sulphur Vents Map (Harvest)|Map:Sulphur Vents Map (Harvest)
Summit Map (Harvest)|Map:Summit Map (Harvest)
Sunken City Map (Harvest)|Map:Sunken City Map (Harvest)
Temple Map (Harvest)|Map:Temple Map (Harvest)
Terrace Map (Harvest)|Map:Terrace Map (Harvest)
The Shaper's Realm (Harvest)|Map:The Shaper's Realm (Harvest)
Thicket Map (Harvest)|Map:Thicket Map (Harvest)
Tower Map (Harvest)|Map:Tower Map (Harvest)
Toxic Sewer Map (Harvest)|Map:Toxic Sewer Map (Harvest)
Tropical Island Map (Harvest)|Map:Tropical Island Map (Harvest)
Underground River Map (Harvest)|Map:Underground River Map (Harvest)
Underground Sea Map (Harvest)|Map:Underground Sea Map (Harvest)
Vaal Pyramid Map (Harvest)|Map:Vaal Pyramid Map (Harvest)
Vaal Temple Map (Harvest)|Map:Vaal Temple Map (Harvest)
Vault Map (Harvest)|Map:Vault Map (Harvest)
Villa Map (Harvest)|Map:Villa Map (Harvest)
Volcano Map (Harvest)|Map:Volcano Map (Harvest)
Waste Pool Map (Harvest)|Map:Waste Pool Map (Harvest)
Wasteland Map (Harvest)|Map:Wasteland Map (Harvest)
Waterways Map (Harvest)|Map:Waterways Map (Harvest)
Wharf Map (Harvest)|Map:Wharf Map (Harvest)
Academy Map (Heist)|Map:Academy Map (Heist)
Acid Caverns Map (Heist)|Map:Acid Caverns Map (Heist)
Alleyways Map (Heist)|Map:Alleyways Map (Heist)
Ancient City Map (Heist)|Map:Ancient City Map (Heist)
Arachnid Nest Map (Heist)|Map:Arachnid Nest Map (Heist)
Arachnid Tomb Map (Heist)|Map:Arachnid Tomb Map (Heist)
Arcade Map (Heist)|Map:Arcade Map (Heist)
Arena Map (Heist)|Map:Arena Map (Heist)
Arid Lake Map (Heist)|Map:Arid Lake Map (Heist)
Armoury Map (Heist)|Map:Armoury Map (Heist)
Arsenal Map (Heist)|Map:Arsenal Map (Heist)
Ashen Wood Map (Heist)|Map:Ashen Wood Map (Heist)
Atoll Map (Heist)|Map:Atoll Map (Heist)
Barrows Map (Heist)|Map:Barrows Map (Heist)
Basilica Map (Heist)|Map:Basilica Map (Heist)
Bazaar Map (Heist)|Map:Bazaar Map (Heist)
Beach Map (Heist)|Map:Beach Map (Heist)
Belfry Map (Heist)|Map:Belfry Map (Heist)
Bog Map (Heist)|Map:Bog Map (Heist)
Bone Crypt Map (Heist)|Map:Bone Crypt Map (Heist)
Burial Chambers Map (Heist)|Map:Burial Chambers Map (Heist)
Cage Map (Heist)|Map:Cage Map (Heist)
Caldera Map (Heist)|Map:Caldera Map (Heist)
Canyon Map (Heist)|Map:Canyon Map (Heist)
Carcass Map (Heist)|Map:Carcass Map (Heist)
Castle Ruins Map (Heist)|Map:Castle Ruins Map (Heist)
Cells Map (Heist)|Map:Cells Map (Heist)
Cemetery Map (Heist)|Map:Cemetery Map (Heist)
Channel Map (Heist)|Map:Channel Map (Heist)
Chateau Map (Heist)|Map:Chateau Map (Heist)
City Square Map (Heist)|Map:City Square Map (Heist)
Colonnade Map (Heist)|Map:Colonnade Map (Heist)
Colosseum Map (Heist)|Map:Colosseum Map (Heist)
Conservatory Map (Heist)|Map:Conservatory Map (Heist)
Coral Ruins Map (Heist)|Map:Coral Ruins Map (Heist)
Core Map (Heist)|Map:Core Map (Heist)
Courthouse Map (Heist)|Map:Courthouse Map (Heist)
Courtyard Map (Heist)|Map:Courtyard Map (Heist)
Coves Map (Heist)|Map:Coves Map (Heist)
Crater Map (Heist)|Map:Crater Map (Heist)
Crimson Temple Map (Heist)|Map:Crimson Temple Map (Heist)
Crystal Ore Map (Heist)|Map:Crystal Ore Map (Heist)
Cursed Crypt Map (Heist)|Map:Cursed Crypt Map (Heist)
Dark Forest Map (Heist)|Map:Dark Forest Map (Heist)
Defiled Cathedral Map (Heist)|Map:Defiled Cathedral Map (Heist)
Desert Map (Heist)|Map:Desert Map (Heist)
Desert Spring Map (Heist)|Map:Desert Spring Map (Heist)
Dig Map (Heist)|Map:Dig Map (Heist)
Dunes Map (Heist)|Map:Dunes Map (Heist)
Dungeon Map (Heist)|Map:Dungeon Map (Heist)
Estuary Map (Heist)|Map:Estuary Map (Heist)
Excavation Map (Heist)|Map:Excavation Map (Heist)
Factory Map (Heist)|Map:Factory Map (Heist)
Fields Map (Heist)|Map:Fields Map (Heist)
Flooded Mine Map (Heist)|Map:Flooded Mine Map (Heist)
Forge of the Phoenix Map (Heist)|Map:Forge of the Phoenix Map (Heist)
Fungal Hollow Map (Heist)|Map:Fungal Hollow Map (Heist)
Gardens Map (Heist)|Map:Gardens Map (Heist)
Geode Map (Heist)|Map:Geode Map (Heist)
Ghetto Map (Heist)|Map:Ghetto Map (Heist)
Glacier Map (Heist)|Map:Glacier Map (Heist)
Graveyard Map (Heist)|Map:Graveyard Map (Heist)
Grotto Map (Heist)|Map:Grotto Map (Heist)
Harbinger Map (High Tier) (Heist)|Map:Harbinger Map (High Tier) (Heist)
Harbinger Map (Low Tier) (Heist)|Map:Harbinger Map (Low Tier) (Heist)
Harbinger Map (Max Tier) (Heist)|Map:Harbinger Map (Max Tier) (Heist)
Harbinger Map (Mid Tier) (Heist)|Map:Harbinger Map (Mid Tier) (Heist)
Haunted Mansion Map (Heist)|Map:Haunted Mansion Map (Heist)
Iceberg Map (Heist)|Map:Iceberg Map (Heist)
Infested Valley Map (Heist)|Map:Infested Valley Map (Heist)
Ivory Temple Map (Heist)|Map:Ivory Temple Map (Heist)
Jungle Valley Map (Heist)|Map:Jungle Valley Map (Heist)
Laboratory Map (Heist)|Map:Laboratory Map (Heist)
Lair Map (Heist)|Map:Lair Map (Heist)
Lair of the Hydra Map (Heist)|Map:Lair of the Hydra Map (Heist)
Lava Chamber Map (Heist)|Map:Lava Chamber Map (Heist)
Lava Lake Map (Heist)|Map:Lava Lake Map (Heist)
Leyline Map (Heist)|Map:Leyline Map (Heist)
Lighthouse Map (Heist)|Map:Lighthouse Map (Heist)
Lookout Map (Heist)|Map:Lookout Map (Heist)
Malformation Map (Heist)|Map:Malformation Map (Heist)
Marshes Map (Heist)|Map:Marshes Map (Heist)
Mausoleum Map (Heist)|Map:Mausoleum Map (Heist)
Maze Map (Heist)|Map:Maze Map (Heist)
Maze of the Minotaur Map (Heist)|Map:Maze of the Minotaur Map (Heist)
Mesa Map (Heist)|Map:Mesa Map (Heist)
Mineral Pools Map (Heist)|Map:Mineral Pools Map (Heist)
Moon Temple Map (Heist)|Map:Moon Temple Map (Heist)
Mud Geyser Map (Heist)|Map:Mud Geyser Map (Heist)
Museum Map (Heist)|Map:Museum Map (Heist)
Necropolis Map (Heist)|Map:Necropolis Map (Heist)
Orchard Map (Heist)|Map:Orchard Map (Heist)
Overgrown Ruin Map (Heist)|Map:Overgrown Ruin Map (Heist)
Overgrown Shrine Map (Heist)|Map:Overgrown Shrine Map (Heist)
Palace Map (Heist)|Map:Palace Map (Heist)
Park Map (Heist)|Map:Park Map (Heist)
Pen Map (Heist)|Map:Pen Map (Heist)
Peninsula Map (Heist)|Map:Peninsula Map (Heist)
Phantasmagoria Map (Heist)|Map:Phantasmagoria Map (Heist)
Pier Map (Heist)|Map:Pier Map (Heist)
Pit Map (Heist)|Map:Pit Map (Heist)
Pit of the Chimera Map (Heist)|Map:Pit of the Chimera Map (Heist)
Plateau Map (Heist)|Map:Plateau Map (Heist)
Plaza Map (Heist)|Map:Plaza Map (Heist)
Port Map (Heist)|Map:Port Map (Heist)
Precinct Map (Heist)|Map:Precinct Map (Heist)
Primordial Blocks Map (Heist)|Map:Primordial Blocks Map (Heist)
Primordial Pool Map (Heist)|Map:Primordial Pool Map (Heist)
Promenade Map (Heist)|Map:Promenade Map (Heist)
Racecourse Map (Heist)|Map:Racecourse Map (Heist)
Ramparts Map (Heist)|Map:Ramparts Map (Heist)
Reef Map (Heist)|Map:Reef Map (Heist)
Relic Chambers Map (Heist)|Map:Relic Chambers Map (Heist)
Residence Map (Heist)|Map:Residence Map (Heist)
Scriptorium Map (Heist)|Map:Scriptorium Map (Heist)
Sepulchre Map (Heist)|Map:Sepulchre Map (Heist)
Shipyard Map (Heist)|Map:Shipyard Map (Heist)
Shore Map (Heist)|Map:Shore Map (Heist)
Shrine Map (Heist)|Map:Shrine Map (Heist)
Siege Map (Heist)|Map:Siege Map (Heist)
Spider Forest Map (Heist)|Map:Spider Forest Map (Heist)
Spider Lair Map (Heist)|Map:Spider Lair Map (Heist)
Strand Map (Heist)|Map:Strand Map (Heist)
Sulphur Vents Map (Heist)|Map:Sulphur Vents Map (Heist)
Summit Map (Heist)|Map:Summit Map (Heist)
Sunken City Map (Heist)|Map:Sunken City Map (Heist)
Temple Map (Heist)|Map:Temple Map (Heist)
Terrace Map (Heist)|Map:Terrace Map (Heist)
The Shaper's Realm (Heist)|Map:The Shaper's Realm (Heist)
Thicket Map (Heist)|Map:Thicket Map (Heist)
Tower Map (Heist)|Map:Tower Map (Heist)
Toxic Sewer Map (Heist)|Map:Toxic Sewer Map (Heist)
Tropical Island Map (Heist)|Map:Tropical Island Map (Heist)
Underground River Map (Heist)|Map:Underground River Map (Heist)
Underground Sea Map (Heist)|Map:Underground Sea Map (Heist)
Vaal Pyramid Map (Heist)|Map:Vaal Pyramid Map (Heist)
Vaal Temple Map (Heist)|Map:Vaal Temple Map (Heist)
Vault Map (Heist)|Map:Vault Map (Heist)
Villa Map (Heist)|Map:Villa Map (Heist)
Volcano Map (Heist)|Map:Volcano Map (Heist)
Waste Pool Map (Heist)|Map:Waste Pool Map (Heist)
Wasteland Map (Heist)|Map:Wasteland Map (Heist)
Waterways Map (Heist)|Map:Waterways Map (Heist)
Wharf Map (Heist)|Map:Wharf Map (Heist)
Academy Map (Ritual)|Map:Academy Map (Ritual)
Acid Caverns Map (Ritual)|Map:Acid Caverns Map (Ritual)
Alleyways Map (Ritual)|Map:Alleyways Map (Ritual)
Ancient City Map (Ritual)|Map:Ancient City Map (Ritual)
Arachnid Nest Map (Ritual)|Map:Arachnid Nest Map (Ritual)
Arachnid Tomb Map (Ritual)|Map:Arachnid Tomb Map (Ritual)
Arcade Map (Ritual)|Map:Arcade Map (Ritual)
Arena Map (Ritual)|Map:Arena Map (Ritual)
Arid Lake Map (Ritual)|Map:Arid Lake Map (Ritual)
Armoury Map (Ritual)|Map:Armoury Map (Ritual)
Arsenal Map (Ritual)|Map:Arsenal Map (Ritual)
Ashen Wood Map (Ritual)|Map:Ashen Wood Map (Ritual)
Atoll Map (Ritual)|Map:Atoll Map (Ritual)
Barrows Map (Ritual)|Map:Barrows Map (Ritual)
Basilica Map (Ritual)|Map:Basilica Map (Ritual)
Bazaar Map (Ritual)|Map:Bazaar Map (Ritual)
Beach Map (Ritual)|Map:Beach Map (Ritual)
Belfry Map (Ritual)|Map:Belfry Map (Ritual)
Bog Map (Ritual)|Map:Bog Map (Ritual)
Bone Crypt Map (Ritual)|Map:Bone Crypt Map (Ritual)
Bramble Valley Map (Ritual)|Map:Bramble Valley Map (Ritual)
Burial Chambers Map (Ritual)|Map:Burial Chambers Map (Ritual)
Cage Map (Ritual)|Map:Cage Map (Ritual)
Caldera Map (Ritual)|Map:Caldera Map (Ritual)
Canyon Map (Ritual)|Map:Canyon Map (Ritual)
Carcass Map (Ritual)|Map:Carcass Map (Ritual)
Castle Ruins Map (Ritual)|Map:Castle Ruins Map (Ritual)
Cells Map (Ritual)|Map:Cells Map (Ritual)
Cemetery Map (Ritual)|Map:Cemetery Map (Ritual)
Channel Map (Ritual)|Map:Channel Map (Ritual)
Chateau Map (Ritual)|Map:Chateau Map (Ritual)
City Square Map (Ritual)|Map:City Square Map (Ritual)
Cold River Map (Ritual)|Map:Cold River Map (Ritual)
Colonnade Map (Ritual)|Map:Colonnade Map (Ritual)
Colosseum Map (Ritual)|Map:Colosseum Map (Ritual)
Conservatory Map (Ritual)|Map:Conservatory Map (Ritual)
Coral Ruins Map (Ritual)|Map:Coral Ruins Map (Ritual)
Core Map (Ritual)|Map:Core Map (Ritual)
Courthouse Map (Ritual)|Map:Courthouse Map (Ritual)
Courtyard Map (Ritual)|Map:Courtyard Map (Ritual)
Coves Map (Ritual)|Map:Coves Map (Ritual)
Crater Map (Ritual)|Map:Crater Map (Ritual)
Crimson Temple Map (Ritual)|Map:Crimson Temple Map (Ritual)
Crimson Township Map (Ritual)|Map:Crimson Township Map (Ritual)
Crystal Ore Map (Ritual)|Map:Crystal Ore Map (Ritual)
Cursed Crypt Map (Ritual)|Map:Cursed Crypt Map (Ritual)
Dark Forest Map (Ritual)|Map:Dark Forest Map (Ritual)
Defiled Cathedral Map (Ritual)|Map:Defiled Cathedral Map (Ritual)
Desert Map (Ritual)|Map:Desert Map (Ritual)
Desert Spring Map (Ritual)|Map:Desert Spring Map (Ritual)
Dig Map (Ritual)|Map:Dig Map (Ritual)
Dry Sea Map (Ritual)|Map:Dry Sea Map (Ritual)
Dunes Map (Ritual)|Map:Dunes Map (Ritual)
Dungeon Map (Ritual)|Map:Dungeon Map (Ritual)
Estuary Map (Ritual)|Map:Estuary Map (Ritual)
Excavation Map (Ritual)|Map:Excavation Map (Ritual)
Factory Map (Ritual)|Map:Factory Map (Ritual)
Fields Map (Ritual)|Map:Fields Map (Ritual)
Flooded Mine Map (Ritual)|Map:Flooded Mine Map (Ritual)
Forbidden Woods Map (Ritual)|Map:Forbidden Woods Map (Ritual)
Forge of the Phoenix Map (Ritual)|Map:Forge of the Phoenix Map (Ritual)
Forking River Map (Ritual)|Map:Forking River Map (Ritual)
Foundry Map (Ritual)|Map:Foundry Map (Ritual)
Frozen Cabins Map (Ritual)|Map:Frozen Cabins Map (Ritual)
Fungal Hollow Map (Ritual)|Map:Fungal Hollow Map (Ritual)
Gardens Map (Ritual)|Map:Gardens Map (Ritual)
Geode Map (Ritual)|Map:Geode Map (Ritual)
Ghetto Map (Ritual)|Map:Ghetto Map (Ritual)
Glacier Map (Ritual)|Map:Glacier Map (Ritual)
Grave Trough Map (Ritual)|Map:Grave Trough Map (Ritual)
Graveyard Map (Ritual)|Map:Graveyard Map (Ritual)
Grotto Map (Ritual)|Map:Grotto Map (Ritual)
Harbinger Map (High Tier) (Ritual)|Map:Harbinger Map (High Tier) (Ritual)
Harbinger Map (Low Tier) (Ritual)|Map:Harbinger Map (Low Tier) (Ritual)
Harbinger Map (Max Tier) (Ritual)|Map:Harbinger Map (Max Tier) (Ritual)
Harbinger Map (Mid Tier) (Ritual)|Map:Harbinger Map (Mid Tier) (Ritual)
Haunted Mansion Map (Ritual)|Map:Haunted Mansion Map (Ritual)
Iceberg Map (Ritual)|Map:Iceberg Map (Ritual)
Infested Valley Map (Ritual)|Map:Infested Valley Map (Ritual)
Ivory Temple Map (Ritual)|Map:Ivory Temple Map (Ritual)
Jungle Valley Map (Ritual)|Map:Jungle Valley Map (Ritual)
Laboratory Map (Ritual)|Map:Laboratory Map (Ritual)
Lair Map (Ritual)|Map:Lair Map (Ritual)
Lair of the Hydra Map (Ritual)|Map:Lair of the Hydra Map (Ritual)
Lava Chamber Map (Ritual)|Map:Lava Chamber Map (Ritual)
Lava Lake Map (Ritual)|Map:Lava Lake Map (Ritual)
Leyline Map (Ritual)|Map:Leyline Map (Ritual)
Lighthouse Map (Ritual)|Map:Lighthouse Map (Ritual)
Lookout Map (Ritual)|Map:Lookout Map (Ritual)
Malformation Map (Ritual)|Map:Malformation Map (Ritual)
Marshes Map (Ritual)|Map:Marshes Map (Ritual)
Mausoleum Map (Ritual)|Map:Mausoleum Map (Ritual)
Maze Map (Ritual)|Map:Maze Map (Ritual)
Maze of the Minotaur Map (Ritual)|Map:Maze of the Minotaur Map (Ritual)
Mesa Map (Ritual)|Map:Mesa Map (Ritual)
Mineral Pools Map (Ritual)|Map:Mineral Pools Map (Ritual)
Moon Temple Map (Ritual)|Map:Moon Temple Map (Ritual)
Mud Geyser Map (Ritual)|Map:Mud Geyser Map (Ritual)
Museum Map (Ritual)|Map:Museum Map (Ritual)
Necropolis Map (Ritual)|Map:Necropolis Map (Ritual)
Orchard Map (Ritual)|Map:Orchard Map (Ritual)
Overgrown Ruin Map (Ritual)|Map:Overgrown Ruin Map (Ritual)
Overgrown Shrine Map (Ritual)|Map:Overgrown Shrine Map (Ritual)
Palace Map (Ritual)|Map:Palace Map (Ritual)
Park Map (Ritual)|Map:Park Map (Ritual)
Pen Map (Ritual)|Map:Pen Map (Ritual)
Peninsula Map (Ritual)|Map:Peninsula Map (Ritual)
Phantasmagoria Map (Ritual)|Map:Phantasmagoria Map (Ritual)
Pier Map (Ritual)|Map:Pier Map (Ritual)
Pit Map (Ritual)|Map:Pit Map (Ritual)
Pit of the Chimera Map (Ritual)|Map:Pit of the Chimera Map (Ritual)
Plateau Map (Ritual)|Map:Plateau Map (Ritual)
Plaza Map (Ritual)|Map:Plaza Map (Ritual)
Port Map (Ritual)|Map:Port Map (Ritual)
Precinct Map (Ritual)|Map:Precinct Map (Ritual)
Primordial Blocks Map (Ritual)|Map:Primordial Blocks Map (Ritual)
Primordial Pool Map (Ritual)|Map:Primordial Pool Map (Ritual)
Promenade Map (Ritual)|Map:Promenade Map (Ritual)
Racecourse Map (Ritual)|Map:Racecourse Map (Ritual)
Ramparts Map (Ritual)|Map:Ramparts Map (Ritual)
Reef Map (Ritual)|Map:Reef Map (Ritual)
Relic Chambers Map (Ritual)|Map:Relic Chambers Map (Ritual)
Residence Map (Ritual)|Map:Residence Map (Ritual)
Scriptorium Map (Ritual)|Map:Scriptorium Map (Ritual)
Sepulchre Map (Ritual)|Map:Sepulchre Map (Ritual)
Shipyard Map (Ritual)|Map:Shipyard Map (Ritual)
Shore Map (Ritual)|Map:Shore Map (Ritual)
Shrine Map (Ritual)|Map:Shrine Map (Ritual)
Siege Map (Ritual)|Map:Siege Map (Ritual)
Silo Map (Ritual)|Map:Silo Map (Ritual)
Spider Forest Map (Ritual)|Map:Spider Forest Map (Ritual)
Spider Lair Map (Ritual)|Map:Spider Lair Map (Ritual)
Stagnation Map (Ritual)|Map:Stagnation Map (Ritual)
Strand Map (Ritual)|Map:Strand Map (Ritual)
Sulphur Vents Map (Ritual)|Map:Sulphur Vents Map (Ritual)
Summit Map (Ritual)|Map:Summit Map (Ritual)
Sunken City Map (Ritual)|Map:Sunken City Map (Ritual)
Temple Map (Ritual)|Map:Temple Map (Ritual)
Terrace Map (Ritual)|Map:Terrace Map (Ritual)
The Shaper's Realm (Ritual)|Map:The Shaper's Realm (Ritual)
Thicket Map (Ritual)|Map:Thicket Map (Ritual)
Tower Map (Ritual)|Map:Tower Map (Ritual)
Toxic Sewer Map (Ritual)|Map:Toxic Sewer Map (Ritual)
Tropical Island Map (Ritual)|Map:Tropical Island Map (Ritual)
Underground River Map (Ritual)|Map:Underground River Map (Ritual)
Underground Sea Map (Ritual)|Map:Underground Sea Map (Ritual)
Vaal Pyramid Map (Ritual)|Map:Vaal Pyramid Map (Ritual)
Vaal Temple Map (Ritual)|Map:Vaal Temple Map (Ritual)
Vault Map (Ritual)|Map:Vault Map (Ritual)
Villa Map (Ritual)|Map:Villa Map (Ritual)
Volcano Map (Ritual)|Map:Volcano Map (Ritual)
Waste Pool Map (Ritual)|Map:Waste Pool Map (Ritual)
Wasteland Map (Ritual)|Map:Wasteland Map (Ritual)
Waterways Map (Ritual)|Map:Waterways Map (Ritual)
Wharf Map (Ritual)|Map:Wharf Map (Ritual)